ء	ʔ
ء	ʔ
ء	ʔ
ء	ʔ
ء	ʔ
آئرلینڈ	aː iː r l iː n ɖ
آئی	aː iː iː
آئین	aː iː iː n
آئینہ	aː iː iː n h
آب	aː b
آباد	aː b aː d̪
آبادانی	aː b aː d̪ aː n iː
آبادی	aː b aː d̪ iː
آبدوز	aː b d̪ oː z
آبشار	aː b ʃ aː r
آبنائے	aː b n aː iː eː
آبچین	aː b t͡ʃ iː n
آبی	aː b iː
آتش	aː t̪ ʃ
آتما	aː t̪ m aː
آتنکوادی	aː t̪ n k oː aː d̪ iː
آج	aː d͡ʒ
آخرت	aː x r t̪
آخری	aː x r iː
آخن	aː x n
آخور	aː x oː r
آداب	aː d̪ aː b
آدر	aː d̪ r
آدم	aː d̪ m
آدمی	aː d̪ m iː
آدھا	aː d̪ʰ aː
آدھنک	aː d̪ʰ n k
آذر	aː z r
آذربائیجان	aː z r b aː iː iː d͡ʒ aː n
آرام	aː r aː m
آربل	aː r b l
آرزو	aː r z oː
آرمبھ	aː r m bʰ
آرمی	aː r m iː
آرمینیا	aː r m iː n iː aː
آرمینیا	aː r m iː n iː aː
آروپ	aː r oː p
آروگیہ	aː r oː g iː h
آریامن	aː r iː aː m n
آریہ	aː r iː h
آرے	aː r eː
آزاد	aː z aː d̪
آزادی	aː z aː d̪ iː
آزمائش	aː z m aː iː ʃ
آزمانا	aː z m aː n aː
آزمودگی	aː z m oː d̪ g iː
آزمودہ	aː z m oː d̪ h
آس	aː s
آسام	aː s aː m
آسامی	aː s aː m iː
آسان	aː s aː n
آسان	aː s aː n
آسانی	aː s aː n iː
آستھا	aː s t̪ʰ aː
آستین	aː s t̪ iː n
آسرا	aː s r aː
آسمان	aː s m aː n
آسمانی	aː s m aː n iː
آسن	aː s n
آسند	aː s n d̪
آسٹریا	aː s ʈ r iː aː
آسٹریلیا	aː s ʈ r iː l iː aː
آسکت	aː s k t̪
آسکول	aː s k oː l
آسیب	aː s iː b
آشچریہ	aː ʃ t͡ʃ r iː h
آشیرواد	aː ʃ iː r oː aː d̪
آغا	aː ɣ aː
آغاز	aː ɣ aː z
آغوش	aː ɣ oː ʃ
آفت	aː f t̪
آفتاب	aː f t̪ aː b
آفتابی	aː f t̪ aː b iː
آفریدی	aː f r iː d̪ iː
آفرین	aː f r iː n
آقا	aː q aː
آقچہ	aː q t͡ʃ h
آلس	aː l s
آلسی	aː l s iː
آلنگن	aː l n g n
آلو	aː l oː
آلود	aː l oː d̪
آلودگی	aː l oː d̪ g iː
آلودہ	aː l oː d̪ h
آلوچنا	aː l oː t͡ʃ n aː
آلچی	aː l t͡ʃ iː
آلہ	aː l h
آم	aː m
آمر	aː m r
آمریت	aː m r iː t̪
آمنہ	aː m n h
آموختہ	aː m oː x t̪ h
آمود	aː m oː d̪
آموزش	aː m oː z ʃ
آمیزش	aː m iː z ʃ
آنا	aː n aː
آندھی	aː n d̪ʰ iː
آنسو	aː n s oː
آنسو	aː n s oː
آنکھ	aː n kʰ
آنکھ	aː n kʰ
آنکھو	aː n kʰ oː
آنکھوں	aː n kʰ oː n
آنکھیں	aː n kʰ iː n
آنگن	aː n g n
آواران	aː oː aː r aː n
آوارہ	aː oː aː r h
آواز	aː oː aː z
آوشيکتا	aː oː ʃ iː k t̪ aː
آٹا	aː ʈ aː
آٹھ	aː ʈʰ
آٹھواں	aː ʈʰ oː aː n
آٹھواں	aː ʈʰ oː aː n
آپ	aː p
آپا	aː p aː
آپی	aː p iː
آچار	aː t͡ʃ aː r
آڑو	aː ɽ oː
آکاش	aː k aː ʃ
آکاشی	aː k aː ʃ iː
آکرشت	aː k r ʃ t̪
آکرمن	aː k r m n
آکھیٹ	aː kʰ iː ʈ
آگ	aː g
آگار	aː g aː r
آگرہ	aː g r h
آگھات	aː gʰ aː t̪
آگے	aː g eː
آہ	aː h
آہستہ	aː h s t̪ h
آہو	aː h oː
آیا	aː iː aː
آیت	aː iː t̪
ا	aː
ا	aː
ا	aː
ا	aː
ابابیل	aː b aː b iː l
اباضی	aː b aː zˤ iː
ابال	aː b aː l
ابالنا	aː b aː l n aː
ابتدا	aː b t̪ d̪ aː
ابتدائی	aː b t̪ d̪ aː iː iː
ابتسام	aː b t̪ s aː m
ابدا	aː b d̪ aː
ابراہیم	aː b r aː h iː m
ابرق	aː b r q
ابرنجن	aː b r n d͡ʒ n
ابرنجین	aː b r n d͡ʒ iː n
ابریق	aː b r iː q
ابلق	aː b l q
ابلنا	aː b l n aː
ابلیس	aː b l iː s
ابلیسیانہ	aː b l iː s iː aː n h
ابن	aː b n
ابنہ	aː b n h
ابو	aː b oː
ابٹن	aː b ʈ n
ابکائی	aː b k aː iː iː
ابھار	aː bʰ aː r
ابھاو	aː bʰ aː oː
ابھرتا	aː bʰ r t̪ aː
ابھشیک	aː bʰ ʃ iː k
ابھمان	aː bʰ m aː n
ابھی	aː bʰ iː
ابھی	aː bʰ iː
ابہام	aː b h aː m
اتارنا	aː t̪ aː r n aː
اتاق	aː t̪ aː q
اتالیق	aː t̪ aː l iː q
اتحاد	aː t̪ h aː d̪
اتحاد	aː t̪ h aː d̪
اتحادی	aː t̪ h aː d̪ iː
اترنا	aː t̪ r n aː
اتصال	aː t̪ sˤ aː l
اتفاق	aː t̪ f aː q
اتفاقا	aː t̪ f aː q aː
اتم	aː t̪ m
اتمام	aː t̪ m aː m
اتمک	aː t̪ m k
اتوار	aː t̪ oː aː r
اتھان	aː t̪ʰ aː n
اتہاس	aː t̪ h aː s
اتہام	aː t̪ h aː m
اتیاچاری	aː t̪ iː aː t͡ʃ aː r iː
اثاث	aː s aː s
اثبات	aː s b aː t̪
اثر	aː s r
اثنا	aː s n aː
اجازت	aː d͡ʒ aː z t̪
اجالا	aː d͡ʒ aː l aː
اجالنا	aː d͡ʒ aː l n aː
اجتماع	aː d͡ʒ t̪ m aː ʔ
اجر	aː d͡ʒ r
اجرا	aː d͡ʒ r aː
اجرت	aː d͡ʒ r t̪
اجزا	aː d͡ʒ z aː
اجل	aː d͡ʒ l
اجلاس	aː d͡ʒ l aː s
اجمالی	aː d͡ʒ m aː l iː
اجنبی	aː d͡ʒ n b iː
اجوائن	aː d͡ʒ oː aː iː n
اجگر	aː d͡ʒ g r
اجی	aː d͡ʒ iː
احباب	aː h b aː b
احتجاج	aː h t̪ d͡ʒ aː d͡ʒ
احترام	aː h t̪ r aː m
احترام	aː h t̪ r aː m
احتمال	aː h t̪ m aː l
احتیاج	aː h t̪ iː aː d͡ʒ
احساس	aː h s aː s
احسان	aː h s aː n
احشا	aː h ʃ aː
احمد	aː h m d̪
احمق	aː h m q
احوال	aː h oː aː l
احیا	aː h iː aː
احیا	aː h iː aː
اخاہ	aː x aː h
اخبار	aː x b aː r
اختلاف	aː x t̪ l aː f
اختہ	aː x t̪ h
اختیار	aː x t̪ iː aː r
اختیاری	aː x t̪ iː aː r iː
اخذ	aː x z
اخروٹ	aː x r oː ʈ
اخلاط	aː x l aː tˤ
اخلاق	aː x l aː q
اخلاق	aː x l aː q
ادا	aː d̪ aː
ادائیگی	aː d̪ aː iː iː g iː
ادارتی	aː d̪ aː r t̪ iː
ادارہ	aː d̪ aː r h
اداری	aː d̪ aː r iː
اداس	aː d̪ aː s
اداسی	aː d̪ aː s iː
اداہرن	aː d̪ aː h r n
ادب	aː d̪ b
ادبا	aː d̪ b aː
ادبی	aː d̪ b iː
ادبیات	aː d̪ b iː aː t̪
ادرنہ	aː d̪ r n h
ادرک	aː d̪ r k
ادریس	aː d̪ r iː s
اديان	aː d̪ iː aː n
ادھار	aː d̪ʰ aː r
ادھلنا	aː d̪ʰ l n aː
ادھماس	aː d̪ʰ m aː s
ادھورا	aː d̪ʰ oː r aː
ادھکار	aː d̪ʰ k aː r
ادھکاری	aː d̪ʰ k aː r iː
ادھیڑ	aː d̪ʰ iː ɽ
ادہم	aː d̪ h m
ادیب	aː d̪ iː b
ادیہ	aː d̪ iː h
اذن	aː z n
اذیت	aː z iː t̪
ارب	aː r b
ارتعاش	aː r t̪ ʔ aː ʃ
ارتھ	aː r t̪ʰ
ارجت	aː r d͡ʒ t̪
ارجن	aː r d͡ʒ n
ارجن	aː r d͡ʒ n
ارجنٹائن	aː r d͡ʒ n ʈ aː iː n
اردلی	aː r d̪ l iː
اردن	aː r d̪ n
اردو	aː r d̪ oː
ارز	aː r z
ارسطو	aː r s tˤ oː
ارش	aː r ʃ
ارض	aː r zˤ
ارغوانی	aː r ɣ oː aː n iː
ارمان	aː r m aː n
ارمنستان	aː r m n s t̪ aː n
ارمیا	aː r m iː aː
ارے	aː r eː
از	aː z
ازبک	aː z b k
ازبکستان	aː z b k s t̪ aː n
ازدواج	aː z d̪ oː aː d͡ʒ
اساس	aː s aː s
اساس	aː s aː s
اساسی	aː s aː s iː
اسباب	aː s b aː b
استاد	aː s t̪ aː d̪
استبداد	aː s t̪ b d̪ aː d̪
استخلاف	aː s t̪ x l aː f
استخوان	aː s t̪ x oː aː n
استر	aː s t̪ r
استری	aː s t̪ r iː
استری	aː s t̪ r iː
استری	aː s t̪ r iː
استعفی	aː s t̪ ʔ f iː
استعمال	aː s t̪ ʔ m aː l
استقبال	aː s t̪ q b aː l
استنبول	aː s t̪ n b oː l
استوار	aː s t̪ oː aː r
استوار	aː s t̪ oː aː r
استور	aː s t̪ oː r
استھ	aː s t̪ʰ
اسحاق	aː s h aː q
اسرائیل	aː s r aː iː iː l
اسراف	aː s r aː f
اسلام	aː s l aː m
اسلامی	aː s l aː m iː
اسلحہ	aː s l h h
اسلحہ	aː s l h h
اسلوب	aː s l oː b
اسم	aː s m
اسم	aː s m
اسماعیل	aː s m aː ʔ iː l
اسٹیشن	aː s ʈ iː ʃ n
اسٹیڈیم	aː s ʈ iː ɖ iː m
اسپ	aː s p
اسپات	aː s p aː t̪
اسپتال	aː s p t̪ aː l
اسپغول	aː s p ɣ oː l
اسکول	aː s k oː l
اسہال	aː s h aː l
اسیر	aː s iː r
اسیری	aː s iː r iː
اشارہ	aː ʃ aː r h
اشاعت	aː ʃ aː ʔ t̪
اشاعت	aː ʃ aː ʔ t̪
اشبھ	aː ʃ bʰ
اشبیلیہ	aː ʃ b iː l iː h
اشتباہا	aː ʃ t̪ b aː h aː
اشتراک	aː ʃ t̪ r aː k
اشتراکیت	aː ʃ t̪ r aː k iː t̪
اشتقاق	aː ʃ t̪ q aː q
اشتہا	aː ʃ t̪ h aː
اشتہار	aː ʃ t̪ h aː r
اشراق	aː ʃ r aː q
اشوک	aː ʃ oː k
اشک	aː ʃ k
اصطبل	aː sˤ tˤ b l
اصطلاح	aː sˤ tˤ l aː h
اصغر	aː sˤ ɣ r
اصل	aː sˤ l
اصلاح	aː sˤ l aː h
اصول	aː sˤ oː l
اصہار	aː sˤ h aː r
اصیل	aː sˤ iː l
اضافہ	aː zˤ aː f h
اضطراری	aː zˤ tˤ r aː r iː
اطالیہ	aː tˤ aː l iː h
اطفال	aː tˤ f aː l
اطلاع	aː tˤ l aː ʔ
اطلاقی	aː tˤ l aː q iː
اطلس	aː tˤ l s
اطمینان	aː tˤ m iː n aː n
اعتبار	aː ʔ t̪ b aː r
اعتراف	aː ʔ t̪ r aː f
اعتماد	aː ʔ t̪ m aː d̪
اعضا	aː ʔ zˤ aː
اعضا	aː ʔ zˤ aː
اعظم	aː ʔ zˤ m
اعلی	aː ʔ l iː
اغوا	aː ɣ oː aː
اغوا	aː ɣ oː aː
افراد	aː f r aː d̪
افریقہ	aː f r iː q h
افزائش	aː f z aː iː ʃ
افسانہ	aː f s aː n h
افطار	aː f tˤ aː r
افطاری	aː f tˤ aː r iː
افغان	aː f ɣ aː n
افغانستان	aː f ɣ aː n s t̪ aː n
افق	aː f q
افلاس	aː f l aː s
اقامت	aː q aː m t̪
اقتدار	aː q t̪ d̪ aː r
اقتصادی	aː q t̪ sˤ aː d̪ iː
اقلیت	aː q l iː t̪
اقلیت	aː q l iː t̪
اقلیم	aː q l iː m
الائچی	aː l aː iː t͡ʃ iː
البانیا	aː l b aː n iː aː
البتہ	aː l b t̪ h
الجزائر	aː l d͡ʒ z aː iː r
الحاق	aː l h aː q
الزام	aː l z aː m
اللہ	aː l l h
اللہ	aː l l h
الم	aː l m
الماری	aː l m aː r iː
الماس	aː l m aː s
النکار	aː l n k aː r
النکرت	aː l n k r t̪
الوداع	aː l oː d̪ aː ʔ
الوداع	aː l oː d̪ aː ʔ
الٹی	aː l ʈ iː
الکحل	aː l k h l
الگ	aː l g
الہام	aː l h aː m
الیاس	aː l iː aː s
الیسع	aː l iː s ʔ
امارت	aː m aː r t̪
امام	aː m aː m
امانت	aː m aː n t̪
امتحان	aː m t̪ h aː n
امداد	aː m d̪ aː d̪
امر	aː m r
امرا	aː m r aː
امرتسر	aː m r t̪ s r
امرود	aː m r oː d̪
امروز	aː m r oː z
امریکا	aː m r iː k aː
امریکہ	aː m r iː k h
امل	aː m l
املا	aː m l aː
امن	aː m n
امور	aː m oː r
امکان	aː m k aː n
امی	aː m iː
امید	aː m iː d̪
امید	aː m iː d̪
امیدوار	aː m iː d̪ oː aː r
امیدوار	aː m iː d̪ oː aː r
امیر	aː m iː r
امینہ	aː m iː n h
اناتھ	aː n aː t̪ʰ
انار	aː n aː r
انارکلی	aː n aː r k l iː
انبار	aː n b aː r
انبیاء	aː n b iː aː ʔ
انت	aː n t̪
انتباہ	aː n t̪ b aː h
انتخاب	aː n t̪ x aː b
انتخاب	aː n t̪ x aː b
انتر	aː n t̪ r
انترم	aː n t̪ r m
انتظار	aː n t̪ zˤ aː r
انتظار	aː n t̪ zˤ aː r
انتظار	aː n t̪ zˤ aː r
انتظام	aː n t̪ zˤ aː m
انتظامی	aː n t̪ zˤ aː m iː
انتظامیہ	aː n t̪ zˤ aː m iː h
انتقال	aː n t̪ q aː l
انتم	aː n t̪ m
انتہائی	aː n t̪ h aː iː iː
انتہاپسند	aː n t̪ h aː p s n d̪
انجام	aː n d͡ʒ aː m
انجانا	aː n d͡ʒ aː n aː
انجیر	aː n d͡ʒ iː r
انداز	aː n d̪ aː z
اندراج	aː n d̪ r aː d͡ʒ
اندلس	aː n d̪ l s
اندھا	aː n d̪ʰ aː
اندھکار	aː n d̪ʰ k aː r
اندھیرا	aː n d̪ʰ iː r aː
اندیکھا	aː n d̪ iː kʰ aː
انسان	aː n s aː n
انسانی	aː n s aː n iː
انش	aː n ʃ
انصاف	aː n sˤ aː f
انطاکیہ	aː n tˤ aː k iː h
انطلیاس	aː n tˤ l iː aː s
انعام	aː n ʔ aː m
انقلاب	aː n q l aː b
انقلاب	aː n q l aː b
انوادک	aː n oː aː d̪ k
انوکھا	aː n oː kʰ aː
انٹارکٹکا	aː n ʈ aː r k ʈ k aː
انپم	aː n p m
انچل	aː n t͡ʃ l
انڈا	aː n ɖ aː
انڈونیشیا	aː n ɖ oː n iː ʃ iː aː
انڈکوش	aː n ɖ k oː ʃ
انڈیا	aː n ɖ iː aː
انکار	aː n k aː r
انکل	aː n k l
انگریز	aː n g r iː z
انگریزی	aː n g r iː z iː
انگلستان	aː n g l s t̪ aː n
انگلی	aː n g l iː
انگلینڈ	aː n g l iː n ɖ
انگور	aː n g oː r
انگوری	aː n g oː r iː
انگولہ	aː n g oː l h
انگوٹھا	aː n g oː ʈʰ aː
انگوٹھی	aː n g oː ʈʰ iː
انگھیٹی	aː n gʰ iː ʈ iː
انھیں	aː n h iː n
انھیں	aː n h iː n
انہ	aː n h
انہیں	aː n h iː n
انہیں	aː n h iː n
انیک	aː n iː k
اوتھل	aː oː t̪ʰ l
اودا	aː oː d̪ aː
اودبلاؤ	aː oː d̪ b l aː oː
اودھی	aː oː d̪ʰ iː
اور	aː oː r
اورماڑا	aː oː r m aː ɽ aː
اورنگ	aː oː r n g
اورنگزیب	aː oː r n g z iː b
اوس	aː oː s
اوساکا	aː oː s aː k aː
اوسطا	aː oː s tˤ aː
اوقات	aː oː q aː t̪
اول	aː oː l
اولا	aː oː l aː
اولاد	aː oː l aː d̪
اولو	aː oː l oː
اولی	aː oː l iː
اولی	aː oː l iː
اولی	aː oː l iː
اونٹ	aː oː n ʈ
اونچائی	aː oː n t͡ʃ aː iː iː
اونگھ	aː oː n gʰ
اوپر	aː oː p r
اوڈیشہ	aː oː ɖ iː ʃ h
اوڑی	aː oː ɽ iː
اوکاش	aː oː k aː ʃ
اوکاڑہ	aː oː k aː ɽ h
اوکھی	aː oː kʰ iː
اوہ	aː oː h
اویغور	aː oː iː ɣ oː r
اویغورستان	aː oː iː ɣ oː r s t̪ aː n
اٹاری	aː ʈ aː r iː
اٹاچی	aː ʈ aː t͡ʃ iː
اٹاچی	aː ʈ aː t͡ʃ iː
اٹک	aː ʈ k
اٹھانا	aː ʈʰ aː n aː
اپاسک	aː p aː s k
اپاہج	aː p aː h d͡ʒ
اپبھوگ	aː p bʰ oː g
اپدهان	aː p d̪ ? aː n
اپدیش	aː p d̪ iː ʃ
اپرادھ	aː p r aː d̪ʰ
اپرادھی	aː p r aː d̪ʰ iː
اپرمپار	aː p r m p aː r
اپریل	aː p r iː l
اپستھت	aː p s t̪ʰ t̪
اپلبدھ	aː p l b d̪ʰ
اپنا	aː p n aː
اپنيتر	aː p n iː t̪ r
اپہار	aː p h aː r
اپیوگ	aː p iː oː g
اچار	aː t͡ʃ aː r
اچانک	aː t͡ʃ aː n k
اچت	aː t͡ʃ t̪
اچکیریہ	aː t͡ʃ k iː r iː h
اچکیریہ	aː t͡ʃ k iː r iː h
اچھا	aː t͡ʃʰ aː
اچھا	aː t͡ʃʰ aː
اچھلنا	aː t͡ʃʰ l n aː
اڑان	aː ɽ aː n
اڑانا	aː ɽ aː n aː
اڑنا	aː ɽ n aː
اڑنا	aː ɽ n aː
اژدہا	aː ʒ d̪ h aː
اک	aː k
اکادمک	aː k aː d̪ m k
اکادمی	aː k aː d̪ m iː
اکال	aː k aː l
اکانوے	aː k aː n oː eː
اکتوبر	aː k t̪ oː b r
اکثر	aː k s r
اکلوتا	aː k l oː t̪ aː
اکنون	aː k n oː n
اکھروٹ	aː kʰ r oː ʈ
اکیلا	aː k iː l aː
اکیلاپن	aː k iː l aː p n
اکیلے	aː k iː l eː
اگر	aː g r
اگربتی	aː g r b t̪ iː
اگرچہ	aː g r t͡ʃ h
اگست	aː g s t̪
اگلا	aː g l aː
اگنا	aː g n aː
اگنی	aː g n iː
ایالت	aː iː aː l t̪
ایت	aː iː t̪
ایتھنز	aː iː t̪ʰ n z
ایتھنز	aː iː t̪ʰ n z
ایتھوپیا	aː iː t̪ʰ oː p iː aː
ایجنٹ	aː iː d͡ʒ n ʈ
ایران	aː iː r aː n
ایرانی	aː iː r aː n iː
ایزد	aː iː z d̪
ایزد	aː iː z d̪
ایزد	aː iː z d̪
ایزد	aː iː z d̪
ایشور	aː iː ʃ oː r
ایلچی	aː iː l t͡ʃ iː
ایمان	aː iː m aː n
ایماندار	aː iː m aː n d̪ aː r
اینٹ	aː iː n ʈ
ایواللہ	aː iː oː aː l l h
ایوان	aː iː oː aː n
ایوب	aː iː oː b
ایڈنبرا	aː iː ɖ n b r aː
ایڈنبرا	aː iː ɖ n b r aː
ایڈنبرا	aː iː ɖ n b r aː
ایک	aː iː k
ب	b
ب	b
بائبل	b aː iː b l
بائیسکل	b aː iː iː s k l
بابو	b aː b oː
بات	b aː t̪
باتھروم	b aː t̪ʰ r oː m
باجی	b aː d͡ʒ iː
باختر	b aː x t̪ r
باد	b aː d̪
بادام	b aː d̪ aː m
بادام	b aː d̪ aː m
بادامی	b aː d̪ aː m iː
بادشاہ	b aː d̪ ʃ aː h
بادشاہت	b aː d̪ ʃ aː h t̪
بادل	b aː d̪ l
بار	b aː r
بارات	b aː r aː t̪
باراں	b aː r aː n
بارش	b aː r ʃ
بارکھان	b aː r kʰ aː n
بارہا	b aː r h aː
باریک	b aː r iː k
بازار	b aː z aː r
بازار	b aː z aː r
بازو	b aː z oː
بازی	b aː z iː
باشندہ	b aː ʃ n d̪ h
باعث	b aː ʔ s
باغ	b aː ɣ
باغی	b aː ɣ iː
باغیچہ	b aː ɣ iː t͡ʃ h
باقی	b aː q iː
بال	b aː l
بالش	b aː l ʃ
بالفعل	b aː l f ʔ l
بالکل	b aː l k l
باندھنا	b aː n d̪ʰ n aː
بانس	b aː n s
بانسو	b aː n s oː
بانسوں	b aː n s oː n
بانو	b aː n oː
بانو	b aː n oː
بانچنا	b aː n t͡ʃ n aː
بانہو	b aː n h oː
بانہوں	b aː n h oː n
بانہہ	b aː n h h
بانہیں	b aː n h iː n
باورچی	b aː oː r t͡ʃ iː
باٹ	b aː ʈ
باڑھ	b aː ɽ h
باکو	b aː k oː
باہر	b aː h r
باہر	b aː h r
باہم	b aː h m
باہمی	b aː h m iː
باہوبلی	b aː h oː b l iː
ببھکشا	b bʰ k ʃ aː
بت	b t̪
بتانا	b t̪ aː n aː
بتانا	b t̪ aː n aː
بجائے	b d͡ʒ aː iː eː
بجری	b d͡ʒ r iː
بجلی	b d͡ʒ l iː
بجے	b d͡ʒ eː
بحال	b h aː l
بحر	b h r
بحران	b h r aː n
بحرین	b h r iː n
بحریہ	b h r iː h
بخش	b x ʃ
بدبو	b d̪ b oː
بدبو	b d̪ b oː
بددعا	b d̪ d̪ ʔ aː
بدر	b d̪ r
بدصورت	b d̪ sˤ oː r t̪
بدعنوانی	b d̪ ʔ n oː aː n iː
بدلنا	b d̪ l n aː
بدلوانا	b d̪ l oː aː n aː
بدلہ	b d̪ l h
بدن	b d̪ n
بدنصیب	b d̪ n sˤ iː b
بدنیت	b d̪ n iː t̪
بدولت	b d̪ oː l t̪
بدھ	b d̪ʰ
بدھرتا	b d̪ʰ r t̪ aː
بدھوار	b d̪ʰ oː aː r
بدھیا	b d̪ʰ iː aː
بدیع	b d̪ iː ʔ
بدیع	b d̪ iː ʔ
بدین	b d̪ iː n
برآمد	b r aː m d̪
برا	b r aː
برات	b r aː t̪
برازیل	b r aː z iː l
برباد	b r b aː d̪
برتن	b r t̪ n
برج	b r d͡ʒ
برس	b r s
برسات	b r s aː t̪
برسلز	b r s l z
برسی	b r s iː
برصغیر	b r sˤ ɣ iː r
برف	b r f
برق	b r q
برقع	b r q ʔ
برقی	b r q iː
برلن	b r l n
برما	b r m aː
برمنگھم	b r m n gʰ m
بروخے	b r oː x eː
برودت	b r oː d̪ t̪
برچھا	b r t͡ʃʰ aː
برچھیت	b r t͡ʃʰ iː t̪
برکت	b r k t̪
برکها	b r k ? aː
برگزیدہ	b r g z iː d̪ h
برہنہ	b r h n h
برہنہ	b r h n h
بریشال	b r iː ʃ aː l
بزار	b z aː r
بزرگ	b z r g
بزرگی	b z r g iː
بس	b s
بستر	b s t̪ r
بستی	b s t̪ iː
بسکٹ	b s k ʈ
بسیار	b s iː aː r
بشیر	b ʃ iː r
بطخ	b tˤ x
بظاہر	b zˤ aː h r
بعث	b ʔ s
بعد	b ʔ d̪
بعلبک	b ʔ l b k
بغاوت	b ɣ aː oː t̪
بغل	b ɣ l
بغیر	b ɣ iː r
بغیچہ	b ɣ iː t͡ʃ h
بقار	b q aː r
بقر	b q r
بقرعید	b q r ʔ iː d̪
بقرعید	b q r ʔ iː d̪
بقرہ	b q r h
بلا	b l aː
بلا	b l aː
بلا	b l aː
بلا	b l aː
بلب	b l b
بلغاری	b l ɣ aː r iː
بلغاریہ	b l ɣ aː r iː h
بلغم	b l ɣ m
بلند	b l n d̪
بلوغت	b l oː ɣ t̪
بلوچستان	b l oː t͡ʃ s t̪ aː n
بلکہ	b l k h
بلہار	b l h aː r
بلی	b l iː
بلیدہ	b l iː d̪ h
بم	b m
بمباری	b m b aː r iː
بمبہ	b m b h
بمقابلہ	b m q aː b l h
بمقابلہ	b m q aː b l h
بمقابلہ	b m q aː b l h
بنا	b n aː
بنا	b n aː
بنارس	b n aː r s
بنانا	b n aː n aː
بناوٹ	b n aː oː ʈ
بناوٹی	b n aː oː ʈ iː
بنت	b n t̪
بنتی	b n t̪ iː
بنجارا	b n d͡ʒ aː r aː
بنجی	b n d͡ʒ iː
بند	b n d̪
بندر	b n d̪ r
بندوق	b n d̪ oː q
بندوق	b n d̪ oː q
بندھن	b n d̪ʰ n
بندہ	b n d̪ h
بنزین	b n z iː n
بنفشی	b n f ʃ iː
بنيان	b n iː aː n
بنگ	b n g
بنگال	b n g aː l
بنگالی	b n g aː l iː
بنیادی	b n iː aː d̪ iː
بو	b oː
بو	b oː
بواب	b oː aː b
بوتل	b oː t̪ l
بوجھ	b oː d͡ʒʰ
بودار	b oː d̪ aː r
بور	b oː r
بوریت	b oː r iː t̪
بوسنیا	b oː s n iː aː
بوسہ	b oː s h
بولنا	b oː l n aː
بولی	b oː l iː
بوم	b oː m
بونا	b oː n aː
بونا	b oː n aː
بونڈر	b oː n ɖ r
بوٹ	b oː ʈ
بوچڑ	b oː t͡ʃ ɽ
بوڑھا	b oː ɽ h aː
بٹن	b ʈ n
بٹوا	b ʈ oː aː
بٹوا	b ʈ oː aː
بٹورنا	b ʈ oː r n aː
بٹھانا	b ʈʰ aː n aː
بپتسمہ	b p t̪ s m h
بچپن	b t͡ʃ p n
بچھو	b t͡ʃʰ oː
بچہ	b t͡ʃ h
بچی	b t͡ʃ iː
بڑا	b ɽ aː
بڑھاپا	b ɽ h aː p aː
بڑھنا	b ɽ h n aː
بکاؤ	b k aː oː
بکاؤ	b k aː oː
بکرا	b k r aː
بکری	b k r iː
بکس	b k s
بکم	b k m
بکم	b k m
بکھراو	b kʰ r aː oː
بھائی	bʰ aː iː iː
بھاجن	bʰ aː d͡ʒ n
بھارت	bʰ aː r t̪
بھاشا	bʰ aː ʃ aː
بھالو	bʰ aː l oː
بھانجا	bʰ aː n d͡ʒ aː
بھانجی	bʰ aː n d͡ʒ iː
بھانگ	bʰ aː n g
بھاگ	bʰ aː g
بھاگنا	bʰ aː g n aː
بھتیجا	bʰ t̪ iː d͡ʒ aː
بھتیجی	bʰ t̪ iː d͡ʒ iː
بھراتا	bʰ r aː t̪ aː
بھرم	bʰ r m
بھرن	bʰ r n
بھرنا	bʰ r n aː
بھروسہ	bʰ r oː s h
بھلوال	bʰ l oː aː l
بھلکڑ	bʰ l k ɽ
بھنجک	bʰ n d͡ʒ k
بھوت	bʰ oː t̪
بھوتنی	bʰ oː t̪ n iː
بھوتنی	bʰ oː t̪ n iː
بھورا	bʰ oː r aː
بھوسڑی	bʰ oː s ɽ iː
بھولنا	bʰ oː l n aː
بھومی	bʰ oː m iː
بھونیشور	bʰ oː n iː ʃ oː r
بھوٹان	bʰ oː ʈ aː n
بھوک	bʰ oː k
بھوگول	bʰ oː g oː l
بھکت	bʰ k t̪
بھکتی	bʰ k t̪ iː
بھکر	bʰ k r
بھگدڑ	bʰ g d̪ ɽ
بھگوان	bʰ g oː aː n
بھی	bʰ iː
بھیا	bʰ iː aː
بھیانک	bʰ iː aː n k
بھیجنا	bʰ iː d͡ʒ n aː
بھید	bʰ iː d̪
بھیس	bʰ iː s
بھیڑ	bʰ iː ɽ
بھیڑ	bʰ iː ɽ
بھیک	bʰ iː k
بہ	b h
بہاؤالدین	b h aː oː aː l d̪ iː n
بہادری	b h aː d̪ r iː
بہادری	b h aː d̪ r iː
بہار	b h aː r
بہار	b h aː r
بہاراں	b h aː r aː n
بہاولنگر	b h aː oː l n g r
بہاولپور	b h aː oː l p oː r
بہت	b h t̪
بہت	b h t̪
بہتر	b h t̪ r
بہتر	b h t̪ r
بہرا	b h r aː
بہرام	b h r aː m
بہرام	b h r aː m
بہروز	b h r oː z
بہشت	b h ʃ t̪
بہن	b h n
بہن	b h n
بہنا	b h n aː
بیت	b iː t̪
بیتا	b iː t̪ aː
بیجا	b iː d͡ʒ aː
بیجنگ	b iː d͡ʒ n g
بیخ	b iː x
بیخ	b iː x
بیدار	b iː d̪ aː r
بیر	b iː r
بیروت	b iː r oː t̪
بیزتی	b iː z t̪ iː
بیزتی	b iː z t̪ iː
بیستی	b iː s t̪ iː
بیش	b iː ʃ
بیشک	b iː ʃ k
بیضہ	b iː zˤ h
بیعت	b iː ʔ t̪
بیعت	b iː ʔ t̪
بیعت	b iː ʔ t̪
بیلاروس	b iː l aː r oː s
بیلجیم	b iː l d͡ʒ iː m
بیلہ	b iː l h
بیمار	b iː m aː r
بیماری	b iː m aː r iː
بینک	b iː n k
بیوی	b iː oː iː
بیٹا	b iː ʈ aː
بیٹھنا	b iː ʈʰ n aː
بیٹھک	b iː ʈʰ k
بیچ	b iː t͡ʃ
بیچنا	b iː t͡ʃ n aː
بیکر	b iː k r
بیگ	b iː g
بیگ	b iː g
بیگم	b iː g m
بے	b eː
ت	t̪
ت	t̪
تابش	t̪ aː b ʃ
تابندہ	t̪ aː b n d̪ h
تاج	t̪ aː d͡ʒ
تاجکستان	t̪ aː d͡ʒ k s t̪ aː n
تار	t̪ aː r
تارا	t̪ aː r aː
تارکین	t̪ aː r k iː n
تاریخ	t̪ aː r iː x
تاریخچہ	t̪ aː r iː x t͡ʃ h
تاریخی	t̪ aː r iː x iː
تاریک	t̪ aː r iː k
تاریکی	t̪ aː r iː k iː
تازہ	t̪ aː z h
تاش	t̪ aː ʃ
تاشقند	t̪ aː ʃ q n d̪
تال	t̪ aː l
تالا	t̪ aː l aː
تالو	t̪ aː l oː
تالی	t̪ aː l iː
تاناشاہ	t̪ aː n aː ʃ aː h
تانبا	t̪ aː n b aː
تاپنا	t̪ aː p n aː
تاڑ	t̪ aː ɽ
تاڑی	t̪ aː ɽ iː
تاہم	t̪ aː h m
تب	t̪ b
تبادلہ	t̪ b aː d̪ l h
تبادلہ	t̪ b aː d̪ l h
تبدیل	t̪ b d̪ iː l
تبریز	t̪ b r iː z
تبصرہ	t̪ b sˤ r h
تتلی	t̪ t̪ l iː
تتکالین	t̪ t̪ k aː l iː n
تجارتی	t̪ d͡ʒ aː r t̪ iː
تجاوز	t̪ d͡ʒ aː oː z
تجربہ	t̪ d͡ʒ r b h
تجزیہ	t̪ d͡ʒ z iː h
تجھے	t̪ d͡ʒʰ eː
تحریک	t̪ h r iː k
تحفظ	t̪ h f zˤ
تحفہ	t̪ h f h
تحفہ	t̪ h f h
تحقیق	t̪ h q iː q
تخت	t̪ x t̪
تختہ	t̪ x t̪ h
تخلیق	t̪ x l iː q
تخم	t̪ x m
تخمہ	t̪ x m h
تخیل	t̪ x iː l
ترازو	t̪ r aː z oː
ترانہ	t̪ r aː n h
تراویح	t̪ r aː oː iː h
تربت	t̪ r b t̪
ترجمان	t̪ r d͡ʒ m aː n
ترجمہ	t̪ r d͡ʒ m h
ترجمہ	t̪ r d͡ʒ m h
ترجیح	t̪ r d͡ʒ iː h
ترجیح	t̪ r d͡ʒ iː h
ترس	t̪ r s
ترقی	t̪ r q iː
ترقی	t̪ r q iː
ترٹی	t̪ r ʈ iː
ترک	t̪ r k
ترکستان	t̪ r k s t̪ aː n
ترکی	t̪ r k iː
ترکیہ	t̪ r k iː h
ترکیے	t̪ r k iː eː
تریپورہ	t̪ r iː p oː r h
تسلیم	t̪ s l iː m
تشریح	t̪ ʃ r iː h
تشنہ	t̪ ʃ n h
تشویشناک	t̪ ʃ oː iː ʃ n aː k
تشکیل	t̪ ʃ k iː l
تصاویر	t̪ sˤ aː oː iː r
تصدیق	t̪ sˤ d̪ iː q
تصور	t̪ sˤ oː r
تصویر	t̪ sˤ oː iː r
تصویرو	t̪ sˤ oː iː r oː
تصویروں	t̪ sˤ oː iː r oː n
تصویریں	t̪ sˤ oː iː r iː n
تعارف	t̪ ʔ aː r f
تعارف	t̪ ʔ aː r f
تعداد	t̪ ʔ d̪ aː d̪
تعداد	t̪ ʔ d̪ aː d̪
تعریف	t̪ ʔ r iː f
تعلق	t̪ ʔ l q
تعلق	t̪ ʔ l q
تعلیم	t̪ ʔ l iː m
تغافل	t̪ ɣ aː f l
تغییر	t̪ ɣ iː iː r
تفاح	t̪ f aː h
تفصیل	t̪ f sˤ iː l
تفنگ	t̪ f n g
تقدیر	t̪ q d̪ iː r
تقریبا	t̪ q r iː b aː
تقلید	t̪ q l iː d̪
تلا	t̪ l aː
تلا	t̪ l aː
تلاوت	t̪ l aː oː t̪
تلخ	t̪ l x
تلخ	t̪ l x
تلخی	t̪ l x iː
تلسی	t̪ l s iː
تلفظ	t̪ l f zˤ
تلوار	t̪ l oː aː r
تم	t̪ m
تماشہ	t̪ m aː ʃ h
تمام	t̪ m aː m
تمرکز	t̪ m r k z
تمغا	t̪ m ɣ aː
تملق	t̪ m l q
تمنا	t̪ m n aː
تمنچہ	t̪ m n t͡ʃ h
تمپ	t̪ m p
تمھارا	t̪ m h aː r aː
تمھیں	t̪ m h iː n
تمہارا	t̪ m h aː r aː
تمہیں	t̪ m h iː n
تمیز	t̪ m iː z
تن	t̪ n
تنازع	t̪ n aː z ʔ
تنبولی	t̪ n b oː l iː
تندر	t̪ n d̪ r
تندر	t̪ n d̪ r
تندر	t̪ n d̪ r
تندرست	t̪ n d̪ r s t̪
تندرستی	t̪ n d̪ r s t̪ iː
تندور	t̪ n d̪ oː r
تنزانیہ	t̪ n z aː n iː h
تنظیم	t̪ n zˤ iː m
تنظیمی	t̪ n zˤ iː m iː
تنقید	t̪ n q iː d̪
تنگ	t̪ n g
تنہائی	t̪ n h aː iː iː
تو	t̪ oː
تو	t̪ oː
توبہ	t̪ oː b h
توبہ	t̪ oː b h
توجہ	t̪ oː d͡ʒ h
توحید	t̪ oː h iː d̪
تودہ	t̪ oː d̪ h
تودہ	t̪ oː d̪ h
توران	t̪ oː r aː n
توقع	t̪ oː q ʔ
تولد	t̪ oː l d̪
تولیہ	t̪ oː l iː h
تولیہ	t̪ oː l iː h
تولیے	t̪ oː l iː eː
توچا	t̪ oː t͡ʃ aː
توڑنا	t̪ oː ɽ n aː
توہین	t̪ oː h iː n
تڑت	t̪ ɽ t̪
تکبر	t̪ k b r
تکبیر	t̪ k b iː r
تکلیف	t̪ k l iː f
تکمیل	t̪ k m iː l
تکھان	t̪ kʰ aː n
تکیہ	t̪ k iː h
تکیہ	t̪ k iː h
تگنا	t̪ g n aː
تھائیلینڈ	t̪ʰ aː iː iː l iː n ɖ
تھوک	t̪ʰ oː k
تھوکنا	t̪ʰ oː k n aː
تہ	t̪ h
تہائی	t̪ h aː iː iː
تہجد	t̪ h d͡ʒ d̪
تہجی	t̪ h d͡ʒ iː
تہذیب	t̪ h z iː b
تہوار	t̪ h oː aː r
تہہ	t̪ h h
تیار	t̪ iː aː r
تیاری	t̪ iː aː r iː
تیاگ	t̪ iː aː g
تیرا	t̪ iː r aː
تیراک	t̪ iː r aː k
تیراکوں	t̪ iː r aː k oː n
تیرنا	t̪ iː r n aː
تیز	t̪ iː z
تیزاب	t̪ iː z aː b
تیسرا	t̪ iː s r aː
تیل	t̪ iː l
تیمور	t̪ iː m oː r
تین	t̪ iː n
تیکھا	t̪ iː kʰ aː
ث	s
ث	s
ثابت	s aː b t̪
ثانیہ	s aː n iː h
ثبوت	s b oː t̪
ثروت	s r oː t̪
ثقافت	s q aː f t̪
ثقالت	s q aː l t̪
ثم	s m
ثواب	s oː aː b
ثورہ	s oː r h
ج	d͡ʒ
ج	d͡ʒ
جائداد	d͡ʒ aː iː d̪ aː d̪
جائداد	d͡ʒ aː iː d̪ aː d̪
جائزہ	d͡ʒ aː iː z h
جائپھل	d͡ʒ aː iː pʰ l
جادو	d͡ʒ aː d̪ oː
جادوگر	d͡ʒ aː d̪ oː g r
جارجیا	d͡ʒ aː r d͡ʒ iː aː
جال	d͡ʒ aː l
جالندھر	d͡ʒ aː l n d̪ʰ r
جام	d͡ʒ aː m
جامعہ	d͡ʒ aː m ʔ h
جامعہ	d͡ʒ aː m ʔ h
جامن	d͡ʒ aː m n
جامن	d͡ʒ aː m n
جامنی	d͡ʒ aː m n iː
جان	d͡ʒ aː n
جاننا	d͡ʒ aː n n aː
جانور	d͡ʒ aː n oː r
جانچنا	d͡ʒ aː n t͡ʃ n aː
جانکاری	d͡ʒ aː n k aː r iː
جاوید	d͡ʒ aː oː iː d̪
جاوید	d͡ʒ aː oː iː d̪
جاپان	d͡ʒ aː p aː n
جاپانی	d͡ʒ aː p aː n iː
جاگنا	d͡ʒ aː g n aː
جاگہ	d͡ʒ aː g h
جب	d͡ʒ b
جبرائیل	d͡ʒ b r aː iː iː l
جبرالٹر	d͡ʒ b r aː l ʈ r
جبوتی	d͡ʒ b oː t̪ iː
جبڑا	d͡ʒ b ɽ aː
جبیل	d͡ʒ b iː l
جتوئی	d͡ʒ t̪ oː iː iː
جدا	d͡ʒ d̪ aː
جدید	d͡ʒ d̪ iː d̪
جرأت	d͡ʒ r ? t̪
جراثیم	d͡ʒ r aː s iː m
جراح	d͡ʒ r aː h
جراحت	d͡ʒ r aː h t̪
جرثومہ	d͡ʒ r s oː m h
جرح	d͡ʒ r h
جرسی	d͡ʒ r s iː
جرم	d͡ʒ r m
جرمانہ	d͡ʒ r m aː n h
جرمن	d͡ʒ r m n
جرمنی	d͡ʒ r m n iː
جرگہ	d͡ʒ r g h
جزیرہ	d͡ʒ z iː r h
جستجو	d͡ʒ s t̪ d͡ʒ oː
جستجو	d͡ʒ s t̪ d͡ʒ oː
جسور	d͡ʒ s oː r
جشن	d͡ʒ ʃ n
جعلی	d͡ʒ ʔ l iː
جغرافیائی	d͡ʒ ɣ r aː f iː aː iː iː
جفتی	d͡ʒ f t̪ iː
جل	d͡ʒ l
جلانا	d͡ʒ l aː n aː
جلسہ	d͡ʒ l s h
جلسہ	d͡ʒ l s h
جلنا	d͡ʒ l n aː
جلوس	d͡ʒ l oː s
جماعت	d͡ʒ m aː ʔ t̪
جماعت	d͡ʒ m aː ʔ t̪
جماگی	d͡ʒ m aː g iː
جمعرات	d͡ʒ m ʔ r aː t̪
جمعرات	d͡ʒ m ʔ r aː t̪
جمعہ	d͡ʒ m ʔ h
جموں	d͡ʒ m oː n
جمہوری	d͡ʒ m h oː r iː
جمہوریت	d͡ʒ m h oː r iː t̪
جمہوریہ	d͡ʒ m h oː r iː h
جمہوریہ	d͡ʒ m h oː r iː h
جن	d͡ʒ n
جن	d͡ʒ n
جناب	d͡ʒ n aː b
جنازو	d͡ʒ n aː z oː
جنازوں	d͡ʒ n aː z oː n
جنازہ	d͡ʒ n aː z h
جنازے	d͡ʒ n aː z eː
جنت	d͡ʒ n t̪
جنتا	d͡ʒ n t̪ aː
جنتی	d͡ʒ n t̪ iː
جنرل	d͡ʒ n r l
جنسی	d͡ʒ n s iː
جنوبی	d͡ʒ n oː b iː
جنوبی	d͡ʒ n oː b iː
جنوری	d͡ʒ n oː r iː
جنگ	d͡ʒ n g
جنگ	d͡ʒ n g
جنگل	d͡ʒ n g l
جنگلا	d͡ʒ n g l aː
جنیئو	d͡ʒ n iː iː oː
جوا	d͡ʒ oː aː
جوا	d͡ʒ oː aː
جوا	d͡ʒ oː aː
جواب	d͡ʒ oː aː b
جواب	d͡ʒ oː aː b
جواد	d͡ʒ oː aː d̪
جواز	d͡ʒ oː aː z
جوانی	d͡ʒ oː aː n iː
جوت	d͡ʒ oː t̪
جوتا	d͡ʒ oː t̪ aː
جور	d͡ʒ oː r
جوز	d͡ʒ oː z
جونپوری	d͡ʒ oː n p oː r iː
جوڑ	d͡ʒ oː ɽ
جوکھم	d͡ʒ oː kʰ m
جوگی	d͡ʒ oː g iː
جوں	d͡ʒ oː n
جوہر	d͡ʒ oː h r
جوہری	d͡ʒ oː h r iː
جوہی	d͡ʒ oː h iː
جٹا	d͡ʒ ʈ aː
جپنا	d͡ʒ p n aː
جڑ	d͡ʒ ɽ
جڑانوالہ	d͡ʒ ɽ aː n oː aː l h
جڑواں	d͡ʒ ɽ oː aː n
جڑواں	d͡ʒ ɽ oː aː n
جگ	d͡ʒ g
جگاڑ	d͡ʒ g aː ɽ
جگر	d͡ʒ g r
جگنا	d͡ʒ g n aː
جگنو	d͡ʒ g n oː
جگہ	d͡ʒ g h
جگہ	d͡ʒ g h
جگہ	d͡ʒ g h
جگہ	d͡ʒ g h
جھارکھنڈ	d͡ʒʰ aː r kʰ n ɖ
جھانجھ	d͡ʒʰ aː n d͡ʒʰ
جھاڑنا	d͡ʒʰ aː ɽ n aː
جھاڑو	d͡ʒʰ aː ɽ oː
جھلمل	d͡ʒʰ l m l
جھنڈا	d͡ʒʰ n ɖ aː
جھنگ	d͡ʒʰ n g
جھولا	d͡ʒʰ oː l aː
جھوٹ	d͡ʒʰ oː ʈ
جھوٹ	d͡ʒʰ oː ʈ
جھوٹا	d͡ʒʰ oː ʈ aː
جھوٹھ	d͡ʒʰ oː ʈʰ
جھیلمی	d͡ʒʰ iː l m iː
جہاد	d͡ʒ h aː d̪
جہاز	d͡ʒ h aː z
جہازی	d͡ʒ h aː z iː
جہان	d͡ʒ h aː n
جہاں	d͡ʒ h aː n
جہلم	d͡ʒ h l m
جہنم	d͡ʒ h n m
جہیز	d͡ʒ h iː z
جی	d͡ʒ iː
جیالا	d͡ʒ iː aː l aː
جیالا	d͡ʒ iː aː l aː
جیبھ	d͡ʒ iː bʰ
جیت	d͡ʒ iː t̪
جیش	d͡ʒ iː ʃ
جیل	d͡ʒ iː l
جین	d͡ʒ iː n
جیوتی	d͡ʒ iː oː t̪ iː
جیومیٹری	d͡ʒ iː oː m iː ʈ r iː
جیون	d͡ʒ iː oː n
جیونی	d͡ʒ iː oː n iː
ح	h
حائل	h aː iː l
حاجت	h aː d͡ʒ t̪
حادثہ	h aː d̪ s h
حاسب	h aː s b
حاصل	h aː sˤ l
حاضری	h aː zˤ r iː
حافظ	h aː f zˤ
حال	h aː l
حالانکہ	h aː l aː n k h
حالانکہ	h aː l aː n k h
حالت	h aː l t̪
حامی	h aː m iː
حب	h b
حبش	h b ʃ
حبشہ	h b ʃ h
حبشی	h b ʃ iː
حبقوق	h b q oː q
حج	h d͡ʒ
حجام	h d͡ʒ aː m
حجرہ	h d͡ʒ r h
حدیث	h d̪ iː s
حراست	h r aː s t̪
حرام	h r aː m
حرمت	h r m t̪
حرمزئی	h r m z iː iː
حساب	h s aː b
حسد	h s d̪
حسین	h s iː n
حسین	h s iː n
حسیں	h s iː n
حشرہ	h ʃ r h
حشفہ	h ʃ f h
حصہ	h sˤ h
حضرت	h zˤ r t̪
حضور	h zˤ oː r
حضور	h zˤ oː r
حفاظت	h f aː zˤ t̪
حقوق	h q oː q
حقہ	h q h
حقیقت	h q iː q t̪
حلال	h l aː l
حلب	h l b
حلقہ	h l q h
حلم	h l m
حلم	h l m
حلیہ	h l iː h
حلیہ	h l iː h
حلیہ	h l iː h
حمار	h m aː r
حمارہ	h m aː r h
حماقت	h m aː q t̪
حماقت	h m aː q t̪
حماقت	h m aː q t̪
حمام	h m aː m
حمایت	h m aː iː t̪
حمد	h m d̪
حملہ	h m l h
حنا	h n aː
حنوکاہ	h n oː k aː h
حواری	h oː aː r iː
حور	h oː r
حوصلہ	h oː sˤ l h
حوصلہ	h oː sˤ l h
حوض	h oː zˤ
حول	h oː l
حویلی	h oː iː l iː
حکایت	h k aː iː t̪
حکم	h k m
حکومت	h k oː m t̪
حکیم	h k iː m
حیا	h iː aː
حیات	h iː aː t̪
حیاتیات	h iː aː t̪ iː aː t̪
حیاتین	h iː aː t̪ iː n
حیران	h iː r aː n
حیفا	h iː f aː
حیفا	h iː f aː
حیوان	h iː oː aː n
حیوانیات	h iː oː aː n iː aː t̪
خ	x
خ	x
خاتمہ	x aː t̪ m h
خاتمہ	x aː t̪ m h
خاتون	x aː t̪ oː n
خادم	x aː d̪ m
خار	x aː r
خاران	x aː r aː n
خارج	x aː r d͡ʒ
خارجہ	x aː r d͡ʒ h
خارجی	x aː r d͡ʒ iː
خارجی	x aː r d͡ʒ iː
خاص	x aː sˤ
خاصا	x aː sˤ aː
خاصی	x aː sˤ iː
خاطر	x aː tˤ r
خاقانیت	x aː q aː n iː t̪
خال	x aː l
خالق	x aː l q
خالی	x aː l iː
خاموش	x aː m oː ʃ
خاموشی	x aː m oː ʃ iː
خان	x aː n
خاندان	x aː n d̪ aː n
خانسامان	x aː n s aː m aː n
خانساماں	x aː n s aː m aː n
خانوزئی	x aː n oː z iː iː
خانپور	x aː n p oː r
خانہ	x aː n h
خانیت	x aː n iː t̪
خانیوال	x aː n iː oː aː l
خاکسار	x aː k s aː r
خاکستری	x aː k s t̪ r iː
خاکی	x aː k iː
خبر	x b r
ختم	x t̪ m
ختم	x t̪ m
خجیر	x d͡ʒ iː r
خجیر	x d͡ʒ iː r
خدا	x d̪ aː
خداوند	x d̪ aː oː n d̪
خدمت	x d̪ m t̪
خدیو	x d̪ iː oː
خدیو	x d̪ iː oː
خدیو	x d̪ iː oː
خراب	x r aː b
خراش	x r aː ʃ
خربوزہ	x r b oː z h
خرد	x r d̪
خرد	x r d̪
خرس	x r s
خرگوش	x r g oː ʃ
خریدنا	x r iː d̪ n aː
خریدوانا	x r iː d̪ oː aː n aː
خزاں	x z aː n
خزاں	x z aː n
خسارہ	x s aː r h
خسرہ	x s r h
خشبو	x ʃ b oː
خشت	x ʃ t̪
خشم	x ʃ m
خصوصا	x sˤ oː sˤ aː
خصوصا	x sˤ oː sˤ aː
خصوصی	x sˤ oː sˤ iː
خضدار	x zˤ d̪ aː r
خط	x tˤ
خطبا	x tˤ b aː
خطبہ	x tˤ b h
خطہ	x tˤ h
خطیب	x tˤ iː b
خطیب	x tˤ iː b
خطیر	x tˤ iː r
خطیہ	x tˤ iː h
خفیہ	x f iː h
خفیہ	x f iː h
خلا	x l aː
خلاف	x l aː f
خلافت	x l aː f t̪
خلفا	x l f aː
خلق	x l q
خلقت	x l q t̪
خلقت	x l q t̪
خلل	x l l
خلیج	x l iː d͡ʒ
خلیفہ	x l iː f h
خنجر	x n d͡ʒ r
خواب	x oː aː b
خواتین	x oː aː t̪ iː n
خواتین	x oː aː t̪ iː n
خواجہ	x oː aː d͡ʒ h
خواجہ	x oː aː d͡ʒ h
خواہ	x oː aː h
خواہ	x oː aː h
خواہر	x oː aː h r
خواہش	x oː aː h ʃ
خواہش	x oː aː h ʃ
خوب	x oː b
خوبانی	x oː b aː n iː
خوبصورت	x oː b sˤ oː r t̪
خود	x oː d̪
خود	x oː d̪
خودمختاری	x oː d̪ m x t̪ aː r iː
خودکش	x oː d̪ k ʃ
خودکشی	x oː d̪ k ʃ iː
خودکشی	x oː d̪ k ʃ iː
خوراک	x oː r aː k
خوش	x oː ʃ
خوشاب	x oː ʃ aː b
خوشبو	x oː ʃ b oː
خوشبودار	x oː ʃ b oː d̪ aː r
خوشی	x oː ʃ iː
خوف	x oː f
خوفناک	x oː f n aː k
خول	x oː l
خون	x oː n
خوک	x oː k
خوں	x oː n
خيرپور	x iː r p oː r
خچر	x t͡ʃ r
خیابان	x iː aː b aː n
خیال	x iː aː l
خیال	x iː aː l
خیال	x iː aː l
خیر	x iː r
خیریت	x iː r iː t̪
خیلا	x iː l aː
خیمہ	x iː m h
د	d̪
د	d̪
داؤد	d̪ aː oː d̪
داخل	d̪ aː x l
داخلہ	d̪ aː x l h
دادا	d̪ aː d̪ aː
دادو	d̪ aː d̪ oː
دادی	d̪ aː d̪ iː
دار	d̪ aː r
داردر	d̪ aː r d̪ r
دارو	d̪ aː r oː
داریل	d̪ aː r iː l
داستان	d̪ aː s t̪ aː n
داستان	d̪ aː s t̪ aː n
داعش	d̪ aː ʔ ʃ
داغ	d̪ aː ɣ
داغستان	d̪ aː ɣ s t̪ aː n
دال	d̪ aː l
دالبندین	d̪ aː l b n d̪ iː n
دام	d̪ aː m
دانت	d̪ aː n t̪
دانتی	d̪ aː n t̪ iː
دانش	d̪ aː n ʃ
داڑم	d̪ aː ɽ m
دایاں	d̪ aː iː aː n
دبئی	d̪ b iː iː
دباؤ	d̪ b aː oː
دبستان	d̪ b s t̪ aː n
دجلہ	d̪ d͡ʒ l h
دختر	d̪ x t̪ r
دخمہ	d̪ x m h
دربار	d̪ r b aː r
درجات	d̪ r d͡ʒ aː t̪
درجہ	d̪ r d͡ʒ h
درخت	d̪ r x t̪
درخش	d̪ r x ʃ
درخواست	d̪ r x oː aː s t̪
درد	d̪ r d̪
دردو	d̪ r d̪ oː
دردوں	d̪ r d̪ oː n
درزی	d̪ r z iː
درست	d̪ r s t̪
درفش	d̪ r f ʃ
درفش	d̪ r f ʃ
درفش	d̪ r f ʃ
دروازہ	d̪ r oː aː z h
دروازہ	d̪ r oː aː z h
دروبست	d̪ r oː b s t̪
درود	d̪ r oː d̪
درگ	d̪ r g
درگاہ	d̪ r g aː h
درہال	d̪ r h aː l
دری	d̪ r iː
دریا	d̪ r iː aː
دریاچہ	d̪ r iː aː t͡ʃ h
دریجی	d̪ r iː d͡ʒ iː
دزد	d̪ z d̪
دس	d̪ s
دستانو	d̪ s t̪ aː n oː
دستانوں	d̪ s t̪ aː n oː n
دستانہ	d̪ s t̪ aː n h
دستانے	d̪ s t̪ aː n eː
دستاویز	d̪ s t̪ aː oː iː z
دستور	d̪ s t̪ oː r
دستک	d̪ s t̪ k
دستکاری	d̪ s t̪ k aː r iː
دستہ	d̪ s t̪ h
دسمبر	d̪ s m b r
دسواں	d̪ s oː aː n
دشت	d̪ ʃ t̪
دشمن	d̪ ʃ m n
دشک	d̪ ʃ k
دعا	d̪ ʔ aː
دعوت	d̪ ʔ oː t̪
دعوت	d̪ ʔ oː t̪
دعوی	d̪ ʔ oː iː
دعوی	d̪ ʔ oː iː
دفاع	d̪ f aː ʔ
دفتر	d̪ f t̪ r
دفعہ	d̪ f ʔ h
دفنانا	d̪ f n aː n aː
دقت	d̪ q t̪
دقیقہ	d̪ q iː q h
دل	d̪ l
دلدادہ	d̪ l d̪ aː d̪ h
دلربا	d̪ l r b aː
دلو	d̪ l oː
دلوں	d̪ l oː n
دلچسپ	d̪ l t͡ʃ s p
دلی	d̪ l iː
دم	d̪ m
دم	d̪ m
دماغ	d̪ m aː ɣ
دمشق	d̪ m ʃ q
دن	d̪ n
دنداسہ	d̪ n d̪ aː s h
دنوں	d̪ n oː n
دنڈ	d̪ n ɖ
دنیا	d̪ n iː aː
دنیا	d̪ n iː aː
دنیاوی	d̪ n iː aː oː iː
دنیور	d̪ n iː oː r
دو	d̪ oː
دوائی	d̪ oː aː iː iː
دوائی	d̪ oː aː iː iː
دوات	d̪ oː aː t̪
دوبارہ	d̪ oː b aː r h
دودمان	d̪ oː d̪ m aː n
دودھ	d̪ oː d̪ʰ
دور	d̪ oː r
دور	d̪ oː r
دوربین	d̪ oː r b iː n
دوردرشن	d̪ oː r d̪ r ʃ n
دورلیکھ	d̪ oː r l iː kʰ
دوزخ	d̪ oː z x
دوست	d̪ oː s t̪
دوستانہ	d̪ oː s t̪ aː n h
دوستی	d̪ oː s t̪ iː
دوسرا	d̪ oː s r aː
دوش	d̪ oː ʃ
دوم	d̪ oː m
دونا	d̪ oː n aː
دونمہ	d̪ oː n m h
دوپہر	d̪ oː p h r
دوڑنا	d̪ oː ɽ n aː
دوکی	d̪ oː k iː
دوگنا	d̪ oː g n aː
دژ	d̪ ʒ
دژ	d̪ ʒ
دژم	d̪ ʒ m
دکھ	d̪ kʰ
دکھانا	d̪ kʰ aː n aː
دکھانا	d̪ kʰ aː n aː
دکھن	d̪ kʰ n
دگنا	d̪ g n aː
دھات	d̪ʰ aː t̪
دھادر	d̪ʰ aː d̪ r
دھارا	d̪ʰ aː r aː
دھارمک	d̪ʰ aː r m k
دھاندل	d̪ʰ aː n d̪ l
دھاندلی	d̪ʰ aː n d̪ l iː
دھبا	d̪ʰ b aː
دھرتی	d̪ʰ r t̪ iː
دھرم	d̪ʰ r m
دھمال	d̪ʰ m aː l
دھماکہ	d̪ʰ m aː k h
دھن	d̪ʰ n
دھن	d̪ʰ n
دھندا	d̪ʰ n d̪ aː
دھندھا	d̪ʰ n d̪ʰ aː
دھواں	d̪ʰ oː aː n
دھوج	d̪ʰ oː d͡ʒ
دھوسر	d̪ʰ oː s r
دھول	d̪ʰ oː l
دھونا	d̪ʰ oː n aː
دھونا	d̪ʰ oː n aː
دھوپ	d̪ʰ oː p
دھڑکن	d̪ʰ ɽ k n
دھیریہ	d̪ʰ iː r iː h
دہ	d̪ h
دہ	d̪ h
دہ	d̪ h
دہائی	d̪ h aː iː iː
دہان	d̪ h aː n
دہشت	d̪ h ʃ t̪
دہقان	d̪ h q aː n
دہقان	d̪ h q aː n
دہقان	d̪ h q aː n
دہلوی	d̪ h l oː iː
دہلوی	d̪ h l oː iː
دہلی	d̪ h l iː
دہلی	d̪ h l iː
دہلی	d̪ h l iː
دہی	d̪ h iː
دہیز	d̪ h iː z
دیا	d̪ iː aː
دیا	d̪ iː aː
دیاوان	d̪ iː aː oː aː n
دیدار	d̪ iː d̪ aː r
دیروز	d̪ iː r oː z
دیز	d̪ iː z
دیس	d̪ iː s
دیسی	d̪ iː s iː
دیش	d̪ iː ʃ
دیشج	d̪ iː ʃ d͡ʒ
دینا	d̪ iː n aː
دینی	d̪ iː n iː
دینے	d̪ iː n eː
دیوانہ	d̪ iː oː aː n h
دیوبندی	d̪ iː oː b n d̪ iː
دیوناگری	d̪ iː oː n aː g r iː
دیپ	d̪ iː p
دیپک	d̪ iː p k
دیپکا	d̪ iː p k aː
دیکھنا	d̪ iː kʰ n aː
دیگچی	d̪ iː g t͡ʃ iː
ذ	z
ذ	z
ذائقہ	z aː iː q h
ذات	z aː t̪
ذرہ	z r h
ذریعہ	z r iː ʔ h
ذلت	z l t̪
ذلیل	z l iː l
ذوق	z oː q
ذکر	z k r
ذکر	z k r
ذیابیطس	z iː aː b iː tˤ s
ر	r
ر	r
رؤسا	r oː s aː
رئیس	r iː iː s
رائس	r aː iː s
رائے	r aː iː eː
رائے	r aː iː eː
رابطہ	r aː b tˤ h
رات	r aː t̪
راتا	r aː t̪ aː
راج	r aː d͡ʒ
راجا	r aː d͡ʒ aː
راجبھاشا	r aː d͡ʒ bʰ aː ʃ aː
راجدھانی	r aː d͡ʒ d̪ʰ aː n iː
راجستھان	r aː d͡ʒ s t̪ʰ aː n
راجستھانی	r aː d͡ʒ s t̪ʰ aː n iː
راجشاہی	r aː d͡ʒ ʃ aː h iː
راجنیہ	r aː d͡ʒ n iː h
راجوری	r aː d͡ʒ oː r iː
راز	r aː z
راستہ	r aː s t̪ h
راضی	r aː zˤ iː
رال	r aː l
رامائن	r aː m aː iː n
ران	r aː n
رانجھا	r aː n d͡ʒʰ aː
رانی	r aː n iː
راولپنڈی	r aː oː l p n ɖ iː
راکٹ	r aː k ʈ
راکھ	r aː kʰ
راکھس	r aː kʰ s
راکھشس	r aː kʰ ʃ s
راہ	r aː h
راہب	r aː h b
راہبہ	r aː h b h
راہداری	r aː h d̪ aː r iː
رب	r b
ربا	r b aː
رباعی	r b aː ʔ iː
ربوہ	r b oː h
رتبہ	r t̪ b h
رتن	r t̪ n
رجا	r d͡ʒ aː
رجل	r d͡ʒ l
رخشان	r x ʃ aː n
رخصتی	r x sˤ t̪ iː
رد	r d̪
رسالہ	r s aː l h
رستم	r s t̪ m
رسن	r s n
رسول	r s oː l
رسی	r s iː
رسید	r s iː d̪
رسیدو	r s iː d̪ oː
رسیدوں	r s iː d̪ oː n
رسیدیں	r s iː d̪ iː n
رشتہ	r ʃ t̪ h
رشوت	r ʃ oː t̪
رشی	r ʃ iː
رضا	r zˤ aː
رضیع	r zˤ iː ʔ
رفتار	r f t̪ aː r
رفتن	r f t̪ n
رفتن	r f t̪ n
رفع	r f ʔ
رفقا	r f q aː
رقص	r q sˤ
رمزی	r m z iː
رمضان	r m zˤ aː n
رمضان	r m zˤ aː n
رمہ	r m h
رنڈی	r n ɖ iː
رنگ	r n g
رنگت	r n g t̪
رنگولی	r n g oː l iː
رنگپور	r n g p oː r
روان	r oː aː n
روانڈا	r oː aː n ɖ aː
روانگی	r oː aː n g iː
روانہ	r oː aː n h
روایت	r oː aː iː t̪
روح	r oː h
روحانی	r oː h aː n iː
روز	r oː z
روزن	r oː z n
روزنامہ	r oː z n aː m h
روزہ	r oː z h
روس	r oː s
روشن	r oː ʃ n
روشن	r oː ʃ n
روشنی	r oː ʃ n iː
روشنی	r oː ʃ n iː
روغن	r oː ɣ n
روغن	r oː ɣ n
رومال	r oː m aː l
رومانیہ	r oː m aː n iː h
رومی	r oː m iː
رونا	r oː n aː
روٹی	r oː ʈ iː
روپ	r oː p
روپیہ	r oː p iː h
روپیہ	r oː p iː h
روچڈیل	r oː t͡ʃ ɖ iː l
روچڈیل	r oː t͡ʃ ɖ iː l
روچڈیل	r oː t͡ʃ ɖ iː l
روی	r oː iː
رویئہ	r oː iː iː h
رویہ	r oː iː h
رڑک	r ɽ k
رکاوٹ	r k aː oː ʈ
رکت	r k t̪
رکشا	r k ʃ aː
رکعت	r k ʔ t̪
رگوید	r g oː iː d̪
رگوید	r g oː iː d̪
رہائش	r h aː iː ʃ
رہائش	r h aː iː ʃ
رہبر	r h b r
رہنا	r h n aː
ریاست	r iː aː s t̪
ریاستہا	r iː aː s t̪ h aː
ریاض	r iː aː zˤ
ریاضی	r iː aː zˤ iː
ریب	r iː b
ریت	r iː t̪
ریختہ	r iː x t̪ h
ریش	r iː ʃ
ریش	r iː ʃ
ریشم	r iː ʃ m
ریشہ	r iː ʃ h
ریشہ	r iː ʃ h
ریپھ	r iː pʰ
ریچھ	r iː t͡ʃʰ
ریڈیو	r iː ɖ iː oː
ریکھا	r iː kʰ aː
ز	z
ز	z
زائر	z aː iː r
زار	z aː r
زایندہ	z aː iː n d̪ h
زایندہ	z aː iː n d̪ h
زبان	z b aː n
زبان	z b aː n
زبردستی	z b r d̪ s t̪ iː
زخم	z x m
زرافہ	z r aː f h
زرتشت	z r t̪ ʃ t̪
زردوزی	z r d̪ oː z iː
زرشک	z r ʃ k
زعفران	z ʔ f r aː n
زمانہ	z m aː n h
زمین	z m iː n
زن	z n
زنجیر	z n d͡ʒ iː r
زندگی	z n d̪ g iː
زندہ	z n d̪ h
زنگ	z n g
زنگبار	z n g b aː r
زنگی	z n g iː
زور	z oː r
زور	z oː r
زوردار	z oː r d̪ aː r
زون	z oː n
زيربند	z iː r b n d̪
زکات	z k aː t̪
زکریا	z k r iː aː
زکوۃ	z k oː ?
زہری	z h r iː
زہیب	z h iː b
زیادتی	z iː aː d̪ t̪ iː
زیادتی	z iː aː d̪ t̪ iː
زیارت	z iː aː r t̪
زیتون	z iː t̪ oː n
زیور	z iː oː r
س	s
س	s
سؤر	s oː r
سؤر	s oː r
سا	s aː
سائز	s aː iː z
سائنس	s aː iː n s
سائنس	s aː iː n s
سائنسدان	s aː iː n s d̪ aː n
سائنسی	s aː iː n s iː
سائنسی	s aː iː n s iː
سائیکل	s aː iː iː k l
سات	s aː t̪
ساتواں	s aː t̪ oː aː n
ساتھ	s aː t̪ʰ
ساتھی	s aː t̪ʰ iː
ساحل	s aː h l
ساحلی	s aː h l iː
سارا	s aː r aː
سازش	s aː z ʃ
سال	s aː l
سالانہ	s aː l aː n h
سالگرہ	s aː l g r h
سامراجیہ	s aː m r aː d͡ʒ iː h
سامعین	s aː m ʔ iː n
سامی	s aː m iː
سامیہ	s aː m iː h
سانبہ	s aː n b h
سانس	s aː n s
سانولا	s aː n oː l aː
سانپ	s aː n p
ساودھان	s aː oː d̪ʰ aː n
ساڑی	s aː ɽ iː
ساکشیہ	s aː k ʃ iː h
ساگر	s aː g r
ساہتیہ	s aː h t̪ iː h
ساہیوال	s aː h iː oː aː l
سب	s b
سبد	s b d̪
سبز	s b z
سبزی	s b z iː
سبھا	s bʰ aː
سبی	s b iː
ستارہ	s t̪ aː r h
ستارے	s t̪ aː r eː
ستم	s t̪ m
ستون	s t̪ oː n
سجدہ	s d͡ʒ d̪ h
سحری	s h r iː
سخی	s x iː
سدابہار	s d̪ aː b h aː r
سدن	s d̪ n
سدھارنا	s d̪ʰ aː r n aː
سدھارک	s d̪ʰ aː r k
سرائیکی	s r aː iː iː k iː
سراب	s r aː b
سرانان	s r aː n aː n
سرحد	s r h d̪
سرخ	s r x
سرخی	s r x iː
سردیاں	s r d̪ iː aː n
سرزمین	s r z m iː n
سرسائی	s r s aː iː iː
سرسوتی	s r s oː t̪ iː
سرسوتی	s r s oː t̪ iː
سرسوں	s r s oː n
سرشت	s r ʃ t̪
سرشپ	s r ʃ p
سرفروش	s r f r oː ʃ
سرما	s r m aː
سرما	s r m aː
سرمایہ	s r m aː iː h
سرمہ	s r m h
سرور	s r oː r
سرورق	s r oː r q
سروش	s r oː ʃ
سرونام	s r oː n aː m
سرکار	s r k aː r
سرکس	s r k s
سرگ	s r g
سرگرم	s r g r m
سرگرمی	s r g r m iː
سرگودھا	s r g oː d̪ʰ aː
سرہانہ	s r h aː n h
سریانی	s r iː aː n iː
سریر	s r iː r
سریع	s r iː ʔ
سزا	s z aː
سسا	s s aː
سسا	s s aː
سست	s s t̪
سستا	s s t̪ aː
سستی	s s t̪ iː
سستی	s s t̪ iː
سسر	s s r
سسر	s s r
سطح	s tˤ h
سغدی	s ɣ d̪ iː
سفارت	s f aː r t̪
سفارش	s f aː r ʃ
سفال	s f aː l
سفر	s f r
سفید	s f iː d̪
سفیر	s f iː r
سلاح	s l aː h
سلام	s l aː m
سلامت	s l aː m t̪
سلامتی	s l aː m t̪ iː
سلجوق	s l d͡ʒ oː q
سلجوقی	s l d͡ʒ oː q iː
سلسلہ	s l s l h
سلطان	s l tˤ aː n
سلطنت	s l tˤ n t̪
سلوواکیہ	s l oː oː aː k iː h
سلوک	s l oː k
سلوک	s l oː k
سلہٹ	s l h ʈ
سلیمان	s l iː m aː n
سمئے	s m iː eː
سماج	s m aː d͡ʒ
سمادھان	s m aː d̪ʰ aː n
سماس	s m aː s
سماعت	s m aː ʔ t̪
سماپت	s m aː p t̪
سماپن	s m aː p n
سماچار	s m aː t͡ʃ aː r
سمبڑیال	s m b ɽ iː aː l
سمجھ	s m d͡ʒʰ
سمجھدار	s m d͡ʒʰ d̪ aː r
سمجھنا	s m d͡ʒʰ n aː
سمجھوتہ	s m d͡ʒʰ oː t̪ h
سمدائے	s m d̪ aː iː eː
سمدر	s m d̪ r
سمراٹ	s m r aː ʈ
سمرتی	s m r t̪ iː
سمرتی	s m r t̪ iː
سمرتی	s m r t̪ iː
سمرقند	s m r q n d̪
سمسم	s m s m
سمع	s m ʔ
سمندر	s m n d̪ r
سمندر	s m n d̪ r
سمندری	s m n d̪ r iː
سموسہ	s m oː s h
سموہ	s m oː h
سمپردائے	s m p r d̪ aː iː eː
سمپردائے	s m p r d̪ aː iː eː
سمکالین	s m k aː l iː n
سمکھ	s m kʰ
سمین	s m iː n
سن	s n
سناتن	s n aː t̪ n
سنانا	s n aː n aː
سناٹا	s n aː ʈ aː
سنت	s n t̪
سنت	s n t̪
سنتان	s n t̪ aː n
سنترا	s n t̪ r aː
سنترا	s n t̪ r aː
سنجھا	s n d͡ʒʰ aː
سندر	s n d̪ r
سندھ	s n d̪ʰ
سندھی	s n d̪ʰ iː
سندیش	s n d̪ iː ʃ
سندیہ	s n d̪ iː h
سنسار	s n s aː r
سنسکرت	s n s k r t̪
سنشیہ	s n ʃ iː h
سننا	s n n aː
سنگ	s n g
سنگاپور	s n g aː p oː r
سنگم	s n g m
سنگھ	s n gʰ
سنگھرش	s n gʰ r ʃ
سنگیت	s n g iː t̪
سنہ	s n h
سنیوگ	s n iː oː g
سنیچر	s n iː t͡ʃ r
سوئی	s oː iː iː
سوادو	s oː aː d̪ oː
سوال	s oː aː l
سوال	s oː aː l
سوالات	s oː aː l aː t̪
سوالو	s oː aː l oː
سوالوں	s oː aː l oː n
سوانگ	s oː aː n g
سواگت	s oː aː g t̪
سوتا	s oː t̪ aː
سوتیلا	s oː t̪ iː l aː
سوتے	s oː t̪ eː
سودا	s oː d̪ aː
سوراب	s oː r aː b
سورج	s oː r d͡ʒ
سورہ	s oː r h
سوری	s oː r iː
سوریہ	s oː r iː h
سوریہ	s oː r iː h
سوستک	s oː s t̪ k
سوغات	s oː ɣ aː t̪
سوم	s oː m
سونا	s oː n aː
سونا	s oː n aː
سويمور	s oː iː m oː r
سوپن	s oː p n
سوچنا	s oː t͡ʃ n aː
سوڈان	s oː ɖ aː n
سوکھا	s oː kʰ aː
سویٹزرلینڈ	s oː iː ʈ z r l iː n ɖ
سویڈن	s oː iː ɖ n
سپارہ	s p aː r h
سپاس	s p aː s
سپاس	s p aː s
سپاہ	s p aː h
سپاہنی	s p aː h n iː
سپاہی	s p aː h iː
سپتاہ	s p t̪ aː h
سپنا	s p n aː
سچ	s t͡ʃ
سڑک	s ɽ k
سکا	s k aː
سکنا	s k n aː
سکندر	s k n d̪ r
سکھ	s kʰ
سکھر	s kʰ r
سکہ	s k h
سگ	s g
سگریٹ	s g r iː ʈ
سہایک	s h aː iː k
سہج	s h d͡ʒ
سہس	s h s
سہمانا	s h m aː n aː
سہمت	s h m t̪
سہمنا	s h m n aː
سہواس	s h oː aː s
سہولت	s h oː l t̪
سہولت	s h oː l t̪
سہیلی	s h iː l iː
سیاحت	s iː aː h t̪
سیارہ	s iː aː r h
سیاست	s iː aː s t̪
سیاستدان	s iː aː s t̪ d̪ aː n
سیاسی	s iː aː s iː
سیالکوٹ	s iː aː l k oː ʈ
سیب	s iː b
سیخ	s iː x
سیر	s iː r
سیلاب	s iː l aː b
سینکڑا	s iː n k ɽ aː
سینکڑا	s iː n k ɽ aː
سینگ	s iː n g
سینیٹر	s iː n iː ʈ r
سیٹھا	s iː ʈʰ aː
سیڑھی	s iː ɽ h iː
سیکھنا	s iː kʰ n aː
سے	s eː
ش	ʃ
ش	ʃ
شاباش	ʃ aː b aː ʃ
شاخ	ʃ aː x
شاد	ʃ aː d̪
شادی	ʃ aː d̪ iː
شارجہ	ʃ aː r d͡ʒ h
شاستر	ʃ aː s t̪ r
شاسن	ʃ aː s n
شاسک	ʃ aː s k
شاعر	ʃ aː ʔ r
شاعرہ	ʃ aː ʔ r h
شاعری	ʃ aː ʔ r iː
شام	ʃ aː m
شامل	ʃ aː m l
شان	ʃ aː n
شانتی	ʃ aː n t̪ iː
شاور	ʃ aː oː r
شاپر	ʃ aː p r
شاگرد	ʃ aː g r d̪
شاہراہ	ʃ aː h r aː h
شاہی	ʃ aː h iː
شاہین	ʃ aː h iː n
شاید	ʃ aː iː d̪
شب	ʃ b
شبد	ʃ b d̪
شبدکوش	ʃ b d̪ k oː ʃ
شبنم	ʃ b n m
شبھ	ʃ bʰ
شتابدی	ʃ t̪ aː b d̪ iː
شترو	ʃ t̪ r oː
شتک	ʃ t̪ k
شجر	ʃ d͡ʒ r
شخص	ʃ x sˤ
شدت	ʃ d̪ t̪
شراب	ʃ r aː b
شرارتی	ʃ r aː r t̪ iː
شرارتی	ʃ r aː r t̪ iː
شرط	ʃ r tˤ
شرطی	ʃ r tˤ iː
شرفا	ʃ r f aː
شرم	ʃ r m
شرمگیں	ʃ r m g iː n
شرک	ʃ r k
شرکرا	ʃ r k r aː
شریر	ʃ r iː r
شریعت	ʃ r iː ʔ t̪
شرینگر	ʃ r iː n g r
ششن	ʃ ʃ n
ششک	ʃ ʃ k
شعر	ʃ ʔ r
شعرا	ʃ ʔ r aː
شعلوں	ʃ ʔ l oː n
شعلہ	ʃ ʔ l h
شعلے	ʃ ʔ l eː
شعیب	ʃ ʔ iː b
شفا	ʃ f aː
شفقت	ʃ f q t̪
شفیق	ʃ f iː q
شقرا	ʃ q r aː
شلیہ	ʃ l iː h
شمال	ʃ m aː l
شمال	ʃ m aː l
شمشیر	ʃ m ʃ iː r
شمشیر	ʃ m ʃ iː r
شناخت	ʃ n aː x t̪
شنتانو	ʃ n t̪ aː n oː
شوربا	ʃ oː r b aː
شوق	ʃ oː q
شوپیاں	ʃ oː p iː aː n
شوہر	ʃ oː h r
شيخوپورہ	ʃ iː x oː p oː r h
شکار	ʃ k aː r
شکارپور	ʃ k aː r p oː r
شکایت	ʃ k aː iː t̪
شکتی	ʃ k t̪ iː
شکر	ʃ k r
شکر	ʃ k r
شکر	ʃ k r
شکریہ	ʃ k r iː h
شگن	ʃ g n
شہادت	ʃ h aː d̪ t̪
شہباز	ʃ h b aː z
شہتوت	ʃ h t̪ oː t̪
شہدا	ʃ h d̪ aː
شہر	ʃ h r
شہروز	ʃ h r oː z
شہری	ʃ h r iː
شہزادہ	ʃ h z aː d̪ h
شہلا	ʃ h l aː
شہنشاہ	ʃ h n ʃ aː h
شہنشاہ	ʃ h n ʃ aː h
شہید	ʃ h iː d̪
شہیدو	ʃ h iː d̪ oː
شہیدوں	ʃ h iː d̪ oː n
شیخ	ʃ iː x
شیدا	ʃ iː d̪ aː
شیدا	ʃ iː d̪ aː
شیر	ʃ iː r
شیر	ʃ iː r
شیشہ	ʃ iː ʃ h
شیطان	ʃ iː tˤ aː n
شیفیلڈ	ʃ iː f iː l ɖ
شیو	ʃ iː oː
شیو	ʃ iː oː
شیکھاواٹی	ʃ iː kʰ aː oː aː ʈ iː
شے	ʃ eː
ص	sˤ
ص	sˤ
صائب	sˤ aː iː b
صابر	sˤ aː b r
صابن	sˤ aː b n
صاحب	sˤ aː h b
صاحب	sˤ aː h b
صاحب	sˤ aː h b
صارف	sˤ aː r f
صارفین	sˤ aː r f iː n
صاف	sˤ aː f
صالح	sˤ aː l h
صبح	sˤ b h
صبح	sˤ b h
صبح	sˤ b h
صبر	sˤ b r
صبر	sˤ b r
صحافی	sˤ h aː f iː
صحافی	sˤ h aː f iː
صحت	sˤ h t̪
صحت	sˤ h t̪
صحن	sˤ h n
صحیح	sˤ h iː h
صحیح	sˤ h iː h
صدا	sˤ d̪ aː
صدقہ	sˤ d̪ q h
صعب	sˤ ʔ b
صعب	sˤ ʔ b
صغیر	sˤ ɣ iː r
صفائی	sˤ f aː iː iː
صفائی	sˤ f aː iː iː
صفحہ	sˤ f h h
صفحہ	sˤ f h h
صفرواں	sˤ f r oː aː n
صلاح	sˤ l aː h
صلاحیت	sˤ l aː h iː t̪
صلوۃ	sˤ l oː ?
صلہ	sˤ l h
صلی	sˤ l iː
صلیب	sˤ l iː b
صلیبی	sˤ l iː b iː
صنعت	sˤ n ʔ t̪
صنم	sˤ n m
صوابی	sˤ oː aː b iː
صوبہ	sˤ oː b h
صورت	sˤ oː r t̪
ض	zˤ
ض	zˤ
ضابطہ	zˤ aː b tˤ h
ضبط	zˤ b tˤ
ضد	zˤ d̪
ضدی	zˤ d̪ iː
ضرر	zˤ r r
ضرور	zˤ r oː r
ضرورت	zˤ r oː r t̪
ضروری	zˤ r oː r iː
ضروری	zˤ r oː r iː
ضلع	zˤ l ʔ
ضم	zˤ m
ضمانت	zˤ m aː n t̪
ضیافت	zˤ iː aː f t̪
ط	tˤ
ط	tˤ
طاعون	tˤ aː ʔ oː n
طاقت	tˤ aː q t̪
طاقتور	tˤ aː q t̪ oː r
طالبان	tˤ aː l b aː n
طبق	tˤ b q
طبلہ	tˤ b l h
طبی	tˤ b iː
طبیب	tˤ b iː b
طبیعت	tˤ b iː ʔ t̪
طبیعی	tˤ b iː ʔ iː
طبیعیات	tˤ b iː ʔ iː aː t̪
طرابلس	tˤ r aː b l s
طرح	tˤ r h
طرح	tˤ r h
طرح	tˤ r h
طرف	tˤ r f
طریقہ	tˤ r iː q h
طشتری	tˤ ʃ t̪ r iː
طعام	tˤ ʔ aː m
طفل	tˤ f l
طلاق	tˤ l aː q
طلعت	tˤ l ʔ t̪
طلوع	tˤ l oː ʔ
طوائف	tˤ oː aː iː f
طوبی	tˤ oː b iː
طور	tˤ oː r
طور	tˤ oː r
طوفان	tˤ oː f aː n
طیارہ	tˤ iː aː r h
طیب	tˤ iː b
طیب	tˤ iː b
طیر	tˤ iː r
ظ	zˤ
ظ	zˤ
ظالم	zˤ aː l m
ظرف	zˤ r f
ظفر	zˤ f r
ظلم	zˤ l m
ع	ʔ
ع	ʔ
ع	ʔ
ع	ʔ
ع	ʔ
عائلہ	ʔ aː iː l h
عائلی	ʔ aː iː l iː
عابد	ʔ aː b d̪
عابدہ	ʔ aː b d̪ h
عادت	ʔ aː d̪ t̪
عاشق	ʔ aː ʃ q
عاصی	ʔ aː sˤ iː
عالم	ʔ aː l m
عالم	ʔ aː l m
عالیہ	ʔ aː l iː h
عام	ʔ aː m
عاملہ	ʔ aː m l h
عبادت	ʔ b aː d̪ t̪
عبادتی	ʔ b aː d̪ t̪ iː
عبرانی	ʔ b r aː n iː
عبری	ʔ b r iː
عجائب	ʔ d͡ʒ aː iː b
عجائب	ʔ d͡ʒ aː iː b
عجائبات	ʔ d͡ʒ aː iː b aː t̪
عجمی	ʔ d͡ʒ m iː
عجوبہ	ʔ d͡ʒ oː b h
عجیب	ʔ d͡ʒ iː b
عدالت	ʔ d̪ aː l t̪
عدس	ʔ d̪ s
عدم	ʔ d̪ m
عراق	ʔ r aː q
عربستان	ʔ r b s t̪ aː n
عربی	ʔ r b iː
عرش	ʔ r ʃ
عرشی	ʔ r ʃ iː
عرض	ʔ r zˤ
عرضی	ʔ r zˤ iː
عرق	ʔ r q
عزیز	ʔ z iː z
عشائیہ	ʔ ʃ aː iː iː h
عشق	ʔ ʃ q
عضو	ʔ zˤ oː
عطر	ʔ tˤ r
عظم	ʔ zˤ m
عظیم	ʔ zˤ iː m
عظیم	ʔ zˤ iː m
عفو	ʔ f oː
عفو	ʔ f oː
عقل	ʔ q l
عقیلہ	ʔ q iː l h
علاج	ʔ l aː d͡ʒ
علاقہ	ʔ l aː q h
علم	ʔ l m
علم	ʔ l m
علما	ʔ l m aː
علمی	ʔ l m iː
علمیات	ʔ l m iː aː t̪
علوم	ʔ l oː m
علی	ʔ l iː
علی	ʔ l iː
علی	ʔ l iː
علیحدگی	ʔ l iː h d̪ g iː
علیحدہ	ʔ l iː h d̪ h
علینہ	ʔ l iː n h
عمان	ʔ m aː n
عمان	ʔ m aː n
عمدہ	ʔ m d̪ h
عمر	ʔ m r
عمر	ʔ m r
عمران	ʔ m r aː n
عمرکوٹ	ʔ m r k oː ʈ
عمل	ʔ m l
عملہ	ʔ m l h
عموما	ʔ m oː m aː
عموما	ʔ m oː m aː
عمومی	ʔ m oː m iː
عنب	ʔ n b
عنصر	ʔ n sˤ r
عنصر	ʔ n sˤ r
عنوان	ʔ n oː aː n
عنوان	ʔ n oː aː n
عوام	ʔ oː aː m
عورت	ʔ oː r t̪
عورت	ʔ oː r t̪
عورتو	ʔ oː r t̪ oː
عورتو	ʔ oː r t̪ oː
عورتوں	ʔ oː r t̪ oː n
عورتوں	ʔ oː r t̪ oː n
عورتیں	ʔ oː r t̪ iː n
عورتیں	ʔ oː r t̪ iː n
عکرشہ	ʔ k r ʃ h
عکس	ʔ k s
عہد	ʔ h d̪
عہدہ	ʔ h d̪ h
عیادت	ʔ iː aː d̪ t̪
عیادت	ʔ iː aː d̪ t̪
عیاشی	ʔ iː aː ʃ iː
عیاشی	ʔ iː aː ʃ iː
عیاں	ʔ iː aː n
عید	ʔ iː d̪
عیسائی	ʔ iː s aː iː iː
عیسائیت	ʔ iː s aː iː iː t̪
عیسی	ʔ iː s iː
عیش	ʔ iː ʃ
عین	ʔ iː n
عینک	ʔ iː n k
غ	ɣ
غ	ɣ
غائب	ɣ aː iː b
غار	ɣ aː r
غالبا	ɣ aː l b aː
غالی	ɣ aː l iː
غدار	ɣ d̪ aː r
غذا	ɣ z aː
غرض	ɣ r zˤ
غرناطہ	ɣ r n aː tˤ h
غروب	ɣ r oː b
غرور	ɣ r oː r
غریب	ɣ r iː b
غزل	ɣ z l
غزوہ	ɣ z oː h
غزہ	ɣ z h
غسل	ɣ s l
غسلخانہ	ɣ s l x aː n h
غش	ɣ ʃ
غضب	ɣ zˤ b
غفلت	ɣ f l t̪
غلام	ɣ l aː m
غلطی	ɣ l tˤ iː
غلہ	ɣ l h
غم	ɣ m
غمر	ɣ m r
غنائیت	ɣ n aː iː iː t̪
غنچہ	ɣ n t͡ʃ h
غنڈہ	ɣ n ɖ h
غنہ	ɣ n h
غور	ɣ oː r
غوٹہ	ɣ oː ʈ h
غژماں	ɣ ʒ m aː n
غیر	ɣ iː r
غیرت	ɣ iː r t̪
ف	f
ف	f
فادر	f aː d̪ r
فارسی	f aː r s iː
فارغ	f aː r ɣ
فاس	f aː s
فاسد	f aː s d̪
فاصلہ	f aː sˤ l h
فاصلہ	f aː sˤ l h
فاضل	f aː zˤ l
فاقہ	f aː q h
فالتو	f aː l t̪ oː
فالج	f aː l d͡ʒ
فالحال	f aː l h aː l
فالسئی	f aː l s iː iː
فالسہ	f aː l s h
فالودہ	f aː l oː d̪ h
فانوس	f aː n oː s
فانی	f aː n iː
فاکہہ	f aː k h h
فتنہ	f t̪ n h
فجی	f d͡ʒ iː
فحش	f h ʃ
فخر	f x r
فدیہ	f d̪ iː h
فرات	f r aː t̪
فرات	f r aː t̪
فراز	f r aː z
فراموش	f r aː m oː ʃ
فرانس	f r aː n s
فرانس	f r aː n s
فرانس	f r aː n s
فرانسیسی	f r aː n s iː s iː
فراہم	f r aː h m
فربہ	f r b h
فرزند	f r z n d̪
فرش	f r ʃ
فرشتہ	f r ʃ t̪ h
فرشتہ	f r ʃ t̪ h
فرص	f r sˤ
فرصت	f r sˤ t̪
فرض	f r zˤ
فرض	f r zˤ
فرضی	f r zˤ iː
فرعون	f r ʔ oː n
فرقہ	f r q h
فرمائش	f r m aː iː ʃ
فرمان	f r m aː n
فرمانا	f r m aː n aː
فرنگی	f r n g iː
فرہنگ	f r h n g
فریاد	f r iː aː d̪
فریال	f r iː aː l
فرینکفرٹ	f r iː n k f r ʈ
فزان	f z aː n
فساد	f s aː d̪
فسادی	f s aː d̪ iː
فسانہ	f s aː n h
فضا	f zˤ aː
فضائیہ	f zˤ aː iː iː h
فطرت	f tˤ r t̪
فقہ	f q h
فقیر	f q iː r
فلاں	f l aː n
فلسطین	f l s tˤ iː n
فلپائن	f l p aː iː n
فلپائن	f l p aː iː n
فلک	f l k
فلکیات	f l k iː aː t̪
فن	f n
فوتگی	f oː t̪ g iː
فوتگی	f oː t̪ g iː
فوج	f oː d͡ʒ
فورا	f oː r aː
فون	f oː n
فون	f oː n
فٹافٹ	f ʈ aː f ʈ
فٹافٹ	f ʈ aː f ʈ
فکر	f k r
فیروزوالہ	f iː r oː z oː aː l h
فیروزہ	f iː r oː z h
فیروزی	f iː r oː z iː
فیصد	f iː sˤ d̪
فیصل	f iː sˤ l
فیصلہ	f iː sˤ l h
فیل	f iː l
ق	q
ق	q
قاب	q aː b
قابض	q aː b zˤ
قابل	q aː b l
قابلیت	q aː b l iː t̪
قاتل	q aː t̪ l
قاتل	q aː t̪ l
قادیان	q aː d̪ iː aː n
قاری	q aː r iː
قاضی	q aː zˤ iː
قاعدہ	q aː ʔ d̪ h
قافلہ	q aː f l h
قافلہ	q aː f l h
قافیہ	q aː f iː h
قاقم	q aː q m
قالین	q aː l iː n
قاموس	q aː m oː s
قانون	q aː n oː n
قانونی	q aː n oː n iː
قاچاقی	q aː t͡ʃ aː q iː
قاہرہ	q aː h r h
قبر	q b r
قبرستان	q b r s t̪ aː n
قبرص	q b r sˤ
قبض	q b zˤ
قبضہ	q b zˤ h
قبل	q b l
قبلتین	q b l t̪ iː n
قبول	q b oː l
قتل	q t̪ l
قدم	q d̪ m
قدم	q d̪ m
قدیم	q d̪ iː m
قرآن	q r aː n
قرار	q r aː r
قراقرم	q r aː q r m
قربانی	q r b aː n iː
قرض	q r zˤ
قرضہ	q r zˤ h
قرطبہ	q r tˤ b h
قرمزی	q r m z iː
قرہ	q r h
قریب	q r iː b
قزاقستان	q z aː q s t̪ aː n
قسط	q s tˤ
قسم	q s m
قسم	q s m
قسمت	q s m t̪
قشنگ	q ʃ n g
قصائی	q sˤ aː iː iː
قصاب	q sˤ aː b
قصاص	q sˤ aː sˤ
قصبات	q sˤ b aː t̪
قصبوں	q sˤ b oː n
قصبہ	q sˤ b h
قصبے	q sˤ b eː
قصور	q sˤ oː r
قصہ	q sˤ h
قطار	q tˤ aː r
قطب	q tˤ b
قطب	q tˤ b
قطعی	q tˤ ʔ iː
ققنس	q q n s
قلات	q l aː t̪
قلب	q l b
قلعہ	q l ʔ h
قلعہ	q l ʔ h
قلعہ	q l ʔ h
قلم	q l m
قلندر	q l n d̪ r
قلی	q l iː
قمچی	q m t͡ʃ iː
قمیص	q m iː sˤ
قمیض	q m iː zˤ
قواعد	q oː aː ʔ d̪
قوت	q oː t̪
قوت	q oː t̪
قوطی	q oː tˤ iː
قوق	q oː q
قوم	q oː m
قومی	q oː m iː
قومیت	q oː m iː t̪
قوی	q oː iː
قوی	q oː iː
قہر	q h r
قہقہہ	q h q h h
قہوہ	q h oː h
قیادت	q iː aː d̪ t̪
قیامت	q iː aː m t̪
قید	q iː d̪
قیمت	q iː m t̪
قیمتی	q iː m t̪ iː
قیمہ	q iː m h
قینچی	q iː n t͡ʃ iː
قے	q eː
كشی	? ʃ iː
ل	l
ل	l
لائبریری	l aː iː b r iː r iː
لائٹر	l aː iː ʈ r
لاجورد	l aː d͡ʒ oː r d̪
لاجوردی	l aː d͡ʒ oː r d̪ iː
لازم	l aː z m
لال	l aː l
لالٹین	l aː l ʈ iː n
لالہ	l aː l h
لامتناہی	l aː m t̪ n aː h iː
لانڈگا	l aː n ɖ g aː
لاوارث	l aː oː aː r s
لاٹھی	l aː ʈʰ iː
لاپتہ	l aː p t̪ h
لاپروا	l aː p r oː aː
لاڈلہ	l aː ɖ l h
لاڑکانہ	l aː ɽ k aː n h
لاکھ	l aː kʰ
لاہور	l aː h oː r
لاہور	l aː h oː r
لاہوری	l aː h oː r iː
لب	l b
لباس	l b aː s
لبنان	l b n aː n
لبنان	l b n aː n
لبھانا	l bʰ aː n aː
لتھوینیا	l t̪ʰ oː iː n iː aː
لجنہ	l d͡ʒ n h
لجنہ	l d͡ʒ n h
لداخ	l d̪ aː x
لدھیانہ	l d̪ʰ iː aː n h
لرزاں	l r z aː n
لسان	l s aː n
لسانیات	l s aː n iː aː t̪
لطفا	l tˤ f aː
لطیفہ	l tˤ iː f h
لعب	l ʔ b
لغت	l ɣ t̪
لغو	l ɣ oː
لغوی	l ɣ oː iː
لفافہ	l f aː f h
لفظ	l f zˤ
لفظ	l f zˤ
لفظ	l f zˤ
لفنگا	l f n g aː
لقب	l q b
لقمان	l q m aː n
للاٹ	l l aː ʈ
لمبا	l m b aː
لمبائی	l m b aː iː iː
لمحاتی	l m h aː t̪ iː
لمپٹ	l m p ʈ
لندن	l n d̪ n
لنگ	l n g
لنگایت	l n g aː iː t̪
لوبیا	l oː b iː aː
لوتھ	l oː t̪ʰ
لودهراں	l oː d̪ ? r aː n
لورالائی	l oː r aː l aː iː iː
لوری	l oː r iː
لوسیل	l oː s iː l
لوط	l oː tˤ
لوٹا	l oː ʈ aː
لوٹا	l oː ʈ aː
لوٹا	l oː ʈ aː
لوگ	l oː g
لوگو	l oː g oː
لوگوں	l oː g oː n
لوہا	l oː h aː
لوہار	l oː h aː r
لڑائی	l ɽ aː iː iː
لڑنا	l ɽ n aː
لڑکا	l ɽ k aː
لڑکی	l ɽ k iː
لکشادیپ	l k ʃ aː d̪ iː p
لکشمی	l k ʃ m iː
لکڑی	l k ɽ iː
لکھائی	l kʰ aː iː iː
لکھنا	l kʰ n aː
لگام	l g aː m
لگانا	l g aː n aː
لگے	l g eː
لہجہ	l h d͡ʒ h
لہذا	l h z aː
لہرانا	l h r aː n aː
لہسن	l h s n
لہنگا	l h n g aː
لہنگا	l h n g aː
لہو	l h oː
لیئج	l iː iː d͡ʒ
لیئج	l iː iː d͡ʒ
لیسٹر	l iː s ʈ r
لیل	l iː l
لیموں	l iː m oː n
لیموں	l iː m oː n
لینا	l iː n aː
لیون	l iː oː n
لیون	l iː oː n
لیوں	l iː oː n
لیوں	l iː oː n
لیٹنا	l iː ʈ n aː
لیکن	l iː k n
لیکھ	l iː kʰ
لیکھنی	l iː kʰ n iː
لیکھک	l iː kʰ k
لیہہ	l iː h h
م	m
م	m
مؤذن	m oː z n
مؤسسہ	m oː s s h
ماء	m aː ʔ
ماتا	m aː t̪ aː
ماتم	m aː t̪ m
ماتھا	m aː t̪ʰ aː
ماحول	m aː h oː l
مارنا	m aː r n aː
مارونی	m aː r oː n iː
مارگ	m aː r g
ماسکو	m aː s k oː
ماضی	m aː zˤ iː
مالا	m aː l aː
مالدیپ	m aː l d̪ iː p
مالٹا	m aː l ʈ aː
مالک	m aː l k
ماما	m aː m aː
ماموں	m aː m oː n
ماندہ	m aː n d̪ h
ماندہ	m aː n d̪ h
مانسہرہ	m aː n s h r h
مانوس	m aː n oː s
مانچسٹر	m aː n t͡ʃ s ʈ r
مانگ	m aː n g
ماہ	m aː h
ماہانہ	m aː h aː n h
ماہر	m aː h r
ماہرین	m aː h r iː n
ماہی	m aː h iː
ماہ‌جبیں	m aː h ? d͡ʒ b iː n
مبارک	m b aː r k
مبارک	m b aː r k
مبلغ	m b l ɣ
مبلغ	m b l ɣ
مبلغ	m b l ɣ
مبنی	m b n iː
مت	m t̪
متجسس	m t̪ d͡ʒ s s
مترا	m t̪ r aː
مترائی	m t̪ r aː iː iː
مترجم	m t̪ r d͡ʒ m
متسیہ	m t̪ s iː h
متعارف	m t̪ ʔ aː r f
متعلق	m t̪ ʔ l q
متلی	m t̪ l iː
متوالی	m t̪ oː aː l iː
متوجہ	m t̪ oː d͡ʒ h
متولد	m t̪ oː l d̪
متولی	m t̪ oː l iː
متھرا	m t̪ʰ r aː
مثال	m s aː l
مثلا	m s l aː
مجبور	m d͡ʒ b oː r
مجرم	m d͡ʒ r m
مجھ	m d͡ʒʰ
مجھے	m d͡ʒʰ eː
مجھے	m d͡ʒʰ eː
مجہول	m d͡ʒ h oː l
محاسب	m h aː s b
محافظ	m h aː f zˤ
محافظت	m h aː f zˤ t̪
محبت	m h b t̪
محبت	m h b t̪
محتسب	m h t̪ s b
محراب	m h r aː b
محراب	m h r aː b
محروم	m h r oː m
محسوس	m h s oː s
محشر	m h ʃ r
محفل	m h f l
محل	m h l
محل	m h l
محلہ	m h l h
محلہ	m h l h
محلہ	m h l h
محمد	m h m d̪
محمد	m h m d̪
محمدی	m h m d̪ iː
محنت	m h n t̪
محنت	m h n t̪
مختصر	m x t̪ sˤ r
مختصرا	m x t̪ sˤ r aː
مختلف	m x t̪ l f
مختلف	m x t̪ l f
مخدوم	m x d̪ oː m
مخزن	m x z n
مخلوط	m x l oː tˤ
مخمل	m x m l
مخملی	m x m l iː
مدت	m d̪ t̪
مدد	m d̪ d̪
مددگار	m d̪ d̪ g aː r
مدرا	m d̪ r aː
مدعی	m d̪ ʔ iː
مدعی	m d̪ ʔ iː
مدھم	m d̪ʰ m
مدیر	m d̪ iː r
مدیرا	m d̪ iː r aː
مدینہ	m d̪ iː n h
مذاق	m z aː q
مذمت	m z m t̪
مذکر	m z k r
مذہب	m z h b
مذہبی	m z h b iː
مراٹھی	m r aː ʈʰ iː
مراکش	m r aː k ʃ
مربا	m r b aː
مربع	m r b ʔ
مرتبہ	m r t̪ b h
مرتیو	m r t̪ iː oː
مرد	m r d̪
مردار	m r d̪ aː r
مردان	m r d̪ aː n
مردانگی	m r d̪ aː n g iː
مردانہ	m r d̪ aː n h
مردنی	m r d̪ n iː
مردنی	m r d̪ n iː
مرض	m r zˤ
مرعش	m r ʔ ʃ
مرغابی	m r ɣ aː b iː
مرغی	m r ɣ iː
مرمت	m r m t̪
مرنا	m r n aː
مروانا	m r oː aː n aː
مرکز	m r k z
مرکزی	m r k z iː
مریدکے	m r iː d̪ k eː
مریض	m r iː zˤ
مریم	m r iː m
مزاج	m z aː d͡ʒ
مزاحمت	m z aː h m t̪
مزدور	m z d̪ oː r
مزور	m z oː r
مزہ	m z h
مزید	m z iː d̪
مزیدار	m z iː d̪ aː r
مسئلہ	m s iː l h
مسئلہ	m s iː l h
مسئلہ	m s iː l h
مسافر	m s aː f r
مستراح	m s t̪ r aː h
مسترد	m s t̪ r d̪
مستعفی	m s t̪ ʔ f iː
مستقبل	m s t̪ q b l
مستقر	m s t̪ q r
مستونگ	m s t̪ oː n g
مسجد	m s d͡ʒ d̪
مسقط	m s q tˤ
مسلسل	m s l s l
مسلمان	m s l m aː n
مسلمہ	m s l m h
مسود	m s oː d̪
مسیح	m s iː h
مسیحا	m s iː h aː
مسیحی	m s iː h iː
مسیحیت	m s iː h iː t̪
مشترکہ	m ʃ t̪ r k h
مشترکہ	m ʃ t̪ r k h
مشرق	m ʃ r q
مشرک	m ʃ r k
مشعل	m ʃ ʔ l
مشغلہ	m ʃ ɣ l h
مشغول	m ʃ ɣ oː l
مشق	m ʃ q
مشقت	m ʃ q t̪
مشوروں	m ʃ oː r oː n
مشورہ	m ʃ oː r h
مشورہ	m ʃ oː r h
مشورے	m ʃ oː r eː
مشک	m ʃ k
مشکل	m ʃ k l
مشہد	m ʃ h d̪
مشہور	m ʃ h oː r
مشہوری	m ʃ h oː r iː
مصالحہ	m sˤ aː l h h
مصالحہ	m sˤ aː l h h
مصالحہ	m sˤ aː l h h
مصر	m sˤ r
مصر	m sˤ r
مصروف	m sˤ r oː f
مصری	m sˤ r iː
مصنف	m sˤ n f
مصیبت	m sˤ iː b t̪
مضموم	m zˤ m oː m
مضمون	m zˤ m oː n
مطالعہ	m tˤ aː l ʔ h
مطعم	m tˤ ʔ m
مطلب	m tˤ l b
مطلقا	m tˤ l q aː
مظاہرہ	m zˤ aː h r h
مظاہرین	m zˤ aː h r iː n
مظلوم	m zˤ l oː m
مع	m ʔ
معاش	m ʔ aː ʃ
معاشرہ	m ʔ aː ʃ r h
معاصر	m ʔ aː sˤ r
معاملہ	m ʔ aː m l h
معاملہ	m ʔ aː m l h
معاہدہ	m ʔ aː h d̪ h
معبد	m ʔ b d̪
معبد	m ʔ b d̪
معبود	m ʔ b oː d̪
معتمد	m ʔ t̪ m d̪
معجزہ	m ʔ d͡ʒ z h
معجزہ	m ʔ d͡ʒ z h
معذرت	m ʔ z r t̪
معذور	m ʔ z oː r
معروف	m ʔ r oː f
معرکہ	m ʔ r k h
معطل	m ʔ tˤ l
معلم	m ʔ l m
معلم	m ʔ l m
معلوم	m ʔ l oː m
معمار	m ʔ m aː r
معماری	m ʔ m aː r iː
معمر	m ʔ m r
معمر	m ʔ m r
معمول	m ʔ m oː l
معیار	m ʔ iː aː r
معیار	m ʔ iː aː r
معیاری	m ʔ iː aː r iː
معیشت	m ʔ iː ʃ t̪
مغل	m ɣ l
مغلوط	m ɣ l oː tˤ
مفاہمت	m f aː h m t̪
مفت	m f t̪
مفتوح	m f t̪ oː h
مفتی	m f t̪ iː
مفہوم	m f h oː m
مقامی	m q aː m iː
مقامی	m q aː m iː
مقبوض	m q b oː zˤ
مقبوضہ	m q b oː zˤ h
مقبول	m q b oː l
مقتل	m q t̪ l
مقدار	m q d̪ aː r
مقدسہ	m q d̪ s h
مقدونی	m q d̪ oː n iː
مقصد	m q sˤ d̪
مقناطيس	m q n aː tˤ iː s
مقناطيس	m q n aː tˤ iː s
مقناطیس	m q n aː tˤ iː s
مقناطیس	m q n aː tˤ iː s
مقیم	m q iː m
ملائیشیا	m l aː iː iː ʃ iː aː
ملاحظہ	m l aː h zˤ h
ملازمت	m l aː z m t̪
ملازمت	m l aː z m t̪
ملاقات	m l aː q aː t̪
ملامت	m l aː m t̪
ملانا	m l aː n aː
ملتان	m l t̪ aː n
ملتانی	m l t̪ aː n iː
ملزم	m l z m
ململ	m l m l
ملن	m l n
ملن	m l n
ملنا	m l n aː
ملنا	m l n aː
ملنسار	m l n s aː r
ملنگ	m l n g
ملوث	m l oː s
ملک	m l k
ملک	m l k
ملکہ	m l k h
ملکہ	m l k h
ملی	m l iː
ملی	m l iː
ملیامیٹ	m l iː aː m iː ʈ
ملیامیٹ	m l iː aː m iː ʈ
ممالک	m m aː l k
ممبئی	m m b iː iː
ممباسہ	m m b aː s h
مملکت	m m l k t̪
ممنوع	m m n oː ʔ
ممکن	m m k n
مناسب	m n aː s b
مناسبت	m n aː s b t̪
مناظر	m n aː zˤ r
منانا	m n aː n aː
منتخب	m n t̪ x b
منتر	m n t̪ r
منتظم	m n t̪ zˤ m
منحوس	m n h oː s
مندر	m n d̪ r
منزل	m n z l
منسلک	m n s l k
منسوخ	m n s oː x
منشور	m n ʃ oː r
منشی	m n ʃ iː
منشی	m n ʃ iː
منشیات	m n ʃ iː aː t̪
منشیہ	m n ʃ iː h
منصوبہ	m n sˤ oː b h
منظر	m n zˤ r
منظم	m n zˤ m
منظور	m n zˤ oː r
منع	m n ʔ
منع	m n ʔ
منقطع	m n q tˤ ʔ
منٹ	m n ʈ
منڈا	m n ɖ aː
منکر	m n k r
منگنی	m n g n iː
منگوانا	m n g oː aː n aː
منگوانا	m n g oː aː n aː
منگیتر	m n g iː t̪ r
منہ	m n h
منی	m n iː
منیت	m n iː t̪
منیت	m n iː t̪
مواصلات	m oː aː sˤ l aː t̪
مواصلات	m oː aː sˤ l aː t̪
مواصلات	m oː aː sˤ l aː t̪
مواقع	m oː aː q ʔ
موج	m oː d͡ʒ
موجود	m oː d͡ʒ oː d̪
موجود	m oː d͡ʒ oː d̪
موجودگی	m oː d͡ʒ oː d̪ g iː
موجودگی	m oː d͡ʒ oː d̪ g iː
موجودہ	m oː d͡ʒ oː d̪ h
مورت	m oː r t̪
مورتی	m oː r t̪ iː
مورمن	m oː r m n
موز	m oː z
موزمبیق	m oː z m b iː q
موسم	m oː s m
موسوم	m oː s oː m
موسی	m oː s iː
موسیقار	m oː s iː q aː r
موسیقی	m oː s iː q iː
موضوع	m oː zˤ oː ʔ
موقع	m oː q ʔ
مول	m oː l
مولا	m oː l aː
مولود	m oː l oː d̪
مومن	m oː m n
مونٹینیگرو	m oː n ʈ iː n iː g r oː
موٹا	m oː ʈ aː
موٹی	m oː ʈ iː
مویشی	m oː iː ʃ iː
مٹانا	m ʈ aː n aː
مٹنا	m ʈ n aː
مٹھی	m ʈʰ iː
مچھ	m t͡ʃʰ
مچھر	m t͡ʃʰ r
مچھلی	m t͡ʃʰ l iː
مژگانی	m ʒ g aː n iː
مکان	m k aː n
مکتب	m k t̪ b
مکروہ	m k r oː h
مکسور	m k s oː r
مکھ	m kʰ
مکھن	m kʰ n
مکھڑا	m kʰ ɽ aː
مکہ	m k h
مگرمچھ	m g r m t͡ʃʰ
مہابھارت	m h aː bʰ aː r t̪
مہاجر	m h aː d͡ʒ r
مہاجر	m h aː d͡ʒ r
مہاجرت	m h aː d͡ʒ r t̪
مہاجرت	m h aː d͡ʒ r t̪
مہاجرین	m h aː d͡ʒ r iː n
مہاجرین	m h aː d͡ʒ r iː n
مہاراشٹر	m h aː r aː ʃ ʈ r
مہاراشٹر	m h aː r aː ʃ ʈ r
مہارانی	m h aː r aː n iː
مہارت	m h aː r t̪
مہان	m h aː n
مہاوت	m h aː oː t̪
مہر	m h r
مہر	m h r
مہر	m h r
مہر	m h r
مہران	m h r aː n
مہران	m h r aː n
مہربان	m h r b aː n
مہربان	m h r b aː n
مہمان	m h m aː n
مہمان	m h m aː n
مہمان	m h m aː n
مہمانی	m h m aː n iː
مہندس	m h n d̪ s
مہندی	m h n d̪ iː
مہندی	m h n d̪ iː
مہندی	m h n d̪ iː
مہندی	m h n d̪ iː
مہنڈر	m h n ɖ r
مہنگا	m h n g aː
مہنگا	m h n g aː
مہنگائی	m h n g aː iː iː
مہیلا	m h iː l aː
مہینا	m h iː n aː
مہینہ	m h iː n h
میانمار	m iː aː n m aː r
میانوالی	m iː aː n oː aː l iː
میاں	m iː aː n
میتھن	m iː t̪ʰ n
میدان	m iː d̪ aː n
میرا	m iː r aː
میرپور	m iː r p oː r
میز	m iː z
میزان	m iː z aː n
میزبان	m iː z b aː n
میزورم	m iː z oː r m
میغ	m iː ɣ
میغ	m iː ɣ
میل	m iː l
مینو	m iː n oː
مینڈھر	m iː n ɖʰ r
مینڈھک	m iː n ɖʰ k
مینگورہ	m iː n g oː r h
مینہ	m iː n h
میور	m iː oː r
میونخ	m iː oː n x
میوہ	m iː oː h
میٹھا	m iː ʈʰ aː
میکائیل	m iː k aː iː iː l
میکسیکو	m iː k s iː k oː
میگھ	m iː gʰ
میگھالیہ	m iː gʰ aː l iː h
میں	m iː n
میں	m iː n
مے	m eː
ن	n
ن	n
ن	n
ن	n
ن	n
نئی	n iː iː
نا	n aː
نائی	n aː iː iː
نائیجیریا	n aː iː iː d͡ʒ iː r iː aː
ناخدا	n aː x d̪ aː
ناخن	n aː x n
نادان	n aː d̪ aː n
ناراض	n aː r aː zˤ
نارنجی	n aː r n d͡ʒ iː
نارنگی	n aː r n g iː
نارووال	n aː r oː oː aː l
ناروے	n aː r oː eː
ناز	n aː z
نازل	n aː z l
نازک	n aː z k
ناستک	n aː s t̪ k
ناشتا	n aː ʃ t̪ aː
ناشر	n aː ʃ r
ناصر	n aː sˤ r
ناصرت	n aː sˤ r t̪
ناصرہ	n aː sˤ r h
ناظر	n aː zˤ r
ناظم	n aː zˤ m
ناف	n aː f
نافرمان	n aː f r m aː n
نافرمانبرداری	n aː f r m aː n b r d̪ aː r iː
ناقوس	n aː q oː s
نال	n aː l
نالی	n aː l iː
نام	n aː m
ناممکن	n aː m m k n
نامہ	n aː m h
نامی	n aː m iː
نان	n aː n
نانا	n aː n aː
نانگل	n aː n g l
نانی	n aː n iː
ناچ	n aː t͡ʃ
ناچنا	n aː t͡ʃ n aː
ناک	n aː k
ناکام	n aː k aː m
ناگ	n aː g
ناگالینڈ	n aː g aː l iː n ɖ
ناگرک	n aː g r k
ناہر	n aː h r
نایاب	n aː iː aː b
نباتیات	n b aː t̪ iː aː t̪
نبض	n b zˤ
نبھانا	n bʰ aː n aː
نتیجتا	n t̪ iː d͡ʒ t̪ aː
نتیجہ	n t̪ iː d͡ʒ h
نثر	n s r
نجبا	n d͡ʒ b aː
نجی	n d͡ʒ iː
نجیب	n d͡ʒ iː b
نخرا	n x r aː
نخست	n x s t̪
نخچیر	n x t͡ʃ iː r
ندرشن	n d̪ r ʃ n
ندی	n d̪ iː
ندیاں	n d̪ iː aː n
ندیو	n d̪ iː oː
ندیوں	n d̪ iː oː n
نر	n r
نردوش	n r d̪ oː ʃ
نرمان	n r m aː n
نرنایک	n r n aː iː k
نرگس	n r g s
نزاکت	n z aː k t̪
نزدیکی	n z d̪ iː k iː
نزہت	n z h t̪
نساء	n s aː ʔ
نسبتا	n s b t̪ aː
نستعلیق	n s t̪ ʔ l iː q
نسخ	n s x
نسخہ	n s x h
نسل	n s l
نشان	n ʃ aː n
نشانی	n ʃ aː n iː
نشریات	n ʃ r iː aː t̪
نشریہ	n ʃ r iː h
نشست	n ʃ s t̪
نشور	n ʃ oː r
نشچت	n ʃ t͡ʃ t̪
نصاب	n sˤ aː b
نصاری	n sˤ aː r iː
نصرانی	n sˤ r aː n iː
نصرت	n sˤ r t̪
نصیب	n sˤ iː b
نظارہ	n zˤ aː r h
نظام	n zˤ aː m
نظامت	n zˤ aː m t̪
نظر	n zˤ r
نظریہ	n zˤ r iː h
نظم	n zˤ m
نظم	n zˤ m
نظیف	n zˤ iː f
نعت	n ʔ t̪
نعرہ	n ʔ r h
نعمت	n ʔ m t̪
نعمت	n ʔ m t̪
نغمہ	n ɣ m h
نفاذ	n f aː z
نفاق	n f aː q
نفرت	n f r t̪
نقاب	n q aː b
نقاب	n q aː b
نقصان	n q sˤ aː n
نقطہ	n q tˤ h
نقلی	n q l iː
نماز	n m aː z
نماز	n m aː z
نمبو	n m b oː
نمستے	n m s t̪ eː
نمونہ	n m oː n h
نمک	n m k
نمکین	n m k iː n
نمی	n m iː
نن	n n
ننگا	n n g aː
ننھا	n n h aː
نو	n oː
نوآبادیاتی	n oː aː b aː d̪ iː aː t̪ iː
نوابشاہ	n oː aː b ʃ aː h
نوبت	n oː b t̪
نوح	n oː h
نور	n oː r
نوش	n oː ʃ
نوشکی	n oː ʃ k iː
نوشہرہ	n oː ʃ h r h
نوشی	n oː ʃ iː
نوواں	n oː oː aː n
نوکر	n oː k r
نوکرانی	n oː k r aː n iː
نوکری	n oː k r iː
نوید	n oː iː d̪
نوید	n oː iː d̪
نویدن	n oː iː d̪ n
نویس	n oː iː s
نویسندہ	n oː iː s n d̪ h
نویسندہ	n oː iː s n d̪ h
نيت	n iː t̪
نپولین	n p oː l iː n
نژاد	n ʒ aː d̪
نژاد	n ʒ aː d̪
نکاح	n k aː h
نکاراتمک	n k aː r aː t̪ m k
نکالنا	n k aː l n aː
نکسیر	n k s iː r
نکما	n k m aː
نگاہ	n g aː h
نگر	n g r
نگرانی	n g r aː n iː
نہ	n h
نہ	n h
نہاد	n h aː d̪
نہایت	n h aː iː t̪
نہضت	n h zˤ t̪
نہیں	n h iː n
نیا	n iː aː
نیر	n iː r
نیز	n iː z
نیم	n iː m
نیم	n iː m
نیم	n iː m
نین	n iː n
نیند	n iː n d̪
نیوجن	n iː oː d͡ʒ n
نیپال	n iː p aː l
نیک	n iː k
نے	n eː
و	oː
و	oː
و	oː
و	oː
و	oː
و	oː
وا	oː aː
وابستگی	oː aː b s t̪ g iː
واحد	oː aː h d̪
وادی	oː aː d̪ iː
وار	oː aː r
وارانسی	oː aː r aː n s iː
وارد	oː aː r d̪
واسط	oː aː s tˤ
واسطہ	oː aː s tˤ h
واسع	oː aː s ʔ
واسی	oː aː s iː
واشک	oː aː ʃ k
واقعات	oː aː q ʔ aː t̪
واقعہ	oː aː q ʔ h
واقف	oː aː q f
والد	oː aː l d̪
والدہ	oː aː l d̪ h
والدین	oː aː l d̪ iː n
والدین	oː aː l d̪ iː n
وامن	oː aː m n
واپس	oː aː p s
واکیہ	oː aː k iː h
واہ	oː aː h
واہک	oː aː h k
وبھاجن	oː bʰ aː d͡ʒ n
وبھاگ	oː bʰ aː g
وتر	oː t̪ r
وتر	oː t̪ r
ودھان	oː d̪ʰ aː n
ودھوا	oː d̪ʰ oː aː
ودیارتھی	oː d̪ iː aː r t̪ʰ iː
ورزش	oː r z ʃ
ورودھ	oː r oː d̪ʰ
وزارت	oː z aː r t̪
وزرا	oː z r aː
وزیر	oː z iː r
وستو	oː s t̪ oː
وسنت	oː s n t̪
وشنو	oː ʃ n oː
وصال	oː sˤ aː l
وضو	oː zˤ oː
وضو	oː zˤ oː
وفا	oː f aː
وفاق	oː f aː q
وفاق	oː f aː q
وفد	oː f d̪
وفد	oː f d̪
وقار	oː q aː r
وقف	oː q f
وقوع	oː q oː ʔ
ولایت	oː l aː iː t̪
ولایتی	oː l aː iː t̪ iː
ولد	oː l d̪
ولندیز	oː l n d̪ iː z
ولی	oː l iː
ونا	oː n aː
وندر	oː n d̪ r
ونشج	oː n ʃ d͡ʒ
وواد	oː oː aː d̪
وچن	oː t͡ʃ n
وڈھ	oː ɖʰ
وکھیات	oː kʰ iː aː t̪
وگیان	oː g iː aː n
وہ	oː h
وہاڑی	oː h aː ɽ iː
وہاں	oː h aː n
وہی	oː h iː
ویتنام	oː iː t̪ n aː m
ویر	oː iː r
ویران	oː iː r aː n
وینجن	oː iː n d͡ʒ n
وینیزویلا	oː iː n iː z oː iː l aː
ویژن	oː iː ʒ n
وے	oː eː
ٹ	ʈ
ٹ	ʈ
ٹالنا	ʈ aː l n aː
ٹانگ	ʈ aː n g
ٹاپو	ʈ aː p oː
ٹرام	ʈ r aː m
ٹرو	ʈ r oː
ٹرک	ʈ r k
ٹریکٹر	ʈ r iː k ʈ r
ٹریکٹر	ʈ r iː k ʈ r
ٹلفورڈ	ʈ l f oː r ɖ
ٹماٹر	ʈ m aː ʈ r
ٹوٹا	ʈ oː ʈ aː
ٹوٹنا	ʈ oː ʈ n aː
ٹوٹی	ʈ oː ʈ iː
ٹوپی	ʈ oː p iː
ٹٹی	ʈ ʈ iː
ٹکر	ʈ k r
ٹکراو	ʈ k r aː oː
ٹکٹ	ʈ k ʈ
ٹھرکی	ʈʰ r k iː
ٹھنڈا	ʈʰ n ɖ aː
ٹھوس	ʈʰ oː s
ٹھوڑی	ʈʰ oː ɽ iː
ٹھڈی	ʈʰ ɖ iː
ٹھکانا	ʈʰ k aː n aː
ٹھہرنا	ʈʰ h r n aː
ٹھہرنا	ʈʰ h r n aː
ٹھیلا	ʈʰ iː l aː
ٹھیکا	ʈʰ iː k aː
ٹھیکیدار	ʈʰ iː k iː d̪ aː r
ٹینگی	ʈ iː n g iː
ٹیپ	ʈ iː p
ٹیکسلا	ʈ iː k s l aː
ٹیکسی	ʈ iː k s iː
پ	p
پ	p
پاؤں	p aː oː n
پاؤں	p aː oː n
پائپ	p aː iː p
پاد	p aː d̪
پادری	p aː d̪ r iː
پارسی	p aː r s iː
پارچہ	p aː r t͡ʃ h
پاسبان	p aː s b aː n
پاستا	p aː s t̪ aː
پاسپورٹ	p aː s p oː r ʈ
پال	p aː l
پالتو	p aː l t̪ oː
پالم	p aː l m
پالنا	p aː l n aː
پالک	p aː l k
پان	p aː n
پانا	p aː n aː
پانو	p aː n oː
پانو	p aː n oː
پانچ	p aː n t͡ʃ
پانچواں	p aː n t͡ʃ oː aː n
پانڈو	p aː n ɖ oː
پانہ	p aː n h
پانی	p aː n iː
پاٹھک	p aː ʈʰ k
پاپ	p aː p
پاکستان	p aː k s t̪ aː n
پاکستانی	p aː k s t̪ aː n iː
پاکپتن	p aː k p t̪ n
پتا	p t̪ aː
پتا	p t̪ aː
پتری	p t̪ r iː
پتلون	p t̪ l oː n
پتنگ	p t̪ n g
پتنی	p t̪ n iː
پتھر	p t̪ʰ r
پتہ	p t̪ h
پتی	p t̪ iː
پتی	p t̪ iː
پد	p d̪
پدر	p d̪ r
پذیر	p z iː r
پر	p r
پراتن	p r aː t̪ n
پرانت	p r aː n t̪
پراٹھا	p r aː ʈʰ aː
پراپت	p r aː p t̪
پراچین	p r aː t͡ʃ iː n
پراکرت	p r aː k r t̪
پربھات	p r bʰ aː t̪
پرتگال	p r t̪ g aː l
پرتگال	p r t̪ g aː l
پرتگیا	p r t̪ g iː aː
پردوں	p r d̪ oː n
پردہ	p r d̪ h
پردیش	p r d̪ iː ʃ
پردے	p r d̪ eː
پرزہ	p r z h
پرستان	p r s t̪ aː n
پرستش	p r s t̪ ʃ
پرسوں	p r s oː n
پرش	p r ʃ
پرش	p r ʃ
پرشنسا	p r ʃ n s aː
پرشیا	p r ʃ iː aː
پرمکھ	p r m kʰ
پرمیشور	p r m iː ʃ oː r
پرمیشور	p r m iː ʃ oː r
پرندہ	p r n d̪ h
پرندہ	p r n d̪ h
پرنی	p r n iː
پروا	p r oː aː
پروار	p r oː aː r
پروت	p r oː t̪
پروردگار	p r oː r d̪ g aː r
پروردگار	p r oː r d̪ g aː r
پرورش	p r oː r ʃ
پرول	p r oː l
پرونا	p r oː n aː
پرچار	p r t͡ʃ aː r
پرچم	p r t͡ʃ m
پرچہ	p r t͡ʃ h
پرچہ	p r t͡ʃ h
پرچی	p r t͡ʃ iː
پرکاش	p r k aː ʃ
پرکاشک	p r k aː ʃ k
پرکھ	p r kʰ
پرکھیات	p r kʰ iː aː t̪
پری	p r iː
پریت	p r iː t̪
پریت	p r iː t̪
پریت	p r iː t̪
پریشان	p r iː ʃ aː n
پریم	p r iː m
پریم	p r iː m
پریڈ	p r iː ɖ
پریکشا	p r iː k ʃ aː
پریکشائیں	p r iː k ʃ aː iː iː n
پستان	p s t̪ aː n
پستک	p s t̪ k
پستہ	p s t̪ h
پسر	p s r
پسند	p s n d̪
پسنی	p s n iː
پسو	p s oː
پسو	p s oː
پسینہ	p s iː n h
پشاور	p ʃ aː oː r
پشتو	p ʃ t̪ oː
پشپ	p ʃ p
پشچم	p ʃ t͡ʃ m
پشین	p ʃ iː n
پل	p l
پل	p l
پلانڈو	p l aː n ɖ oː
پلنگ	p l n g
پلٹنا	p l ʈ n aː
پنا	p n aː
پناہ	p n aː h
پنجاب	p n d͡ʒ aː b
پنجابی	p n d͡ʒ aː b iː
پنجہ	p n d͡ʒ h
پنسل	p n s l
پنسل	p n s l
پنچھی	p n t͡ʃʰ iː
پنڈال	p n ɖ aː l
پنکھ	p n kʰ
پنکھا	p n kʰ aː
پنکھڑی	p n kʰ ɽ iː
پنگھٹ	p n gʰ ʈ
پنیر	p n iː r
پنیہ	p n iː h
پنیہ	p n iː h
پوت	p oː t̪
پوجا	p oː d͡ʒ aː
پوجنا	p oː d͡ʒ n aː
پوجک	p oː d͡ʒ k
پور	p oː r
پورا	p oː r aː
پوربی	p oː r b iː
پوست	p oː s t̪
پوشاک	p oː ʃ aː k
پولس	p oː l s
پولس	p oː l s
پولینڈ	p oː l iː n ɖ
پون	p oː n
پونچھ	p oː n t͡ʃʰ
پوپ	p oː p
پوپ	p oː p
پوچھنا	p oː t͡ʃʰ n aː
پٹاخا	p ʈ aː x aː
پٹل	p ʈ l
پٹواری	p ʈ oː aː r iː
پٹواری	p ʈ oː aː r iː
پٹول	p ʈ oː l
پٹھان	p ʈʰ aː n
پٹی	p ʈ iː
پپاسا	p p aː s aː
پچھتر	p t͡ʃʰ t̪ r
پچھواڑا	p t͡ʃʰ oː aː ɽ aː
پڑوسی	p ɽ oː s iː
پڑھائی	p ɽ h aː iː iː
پڑھنا	p ɽ h n aː
پژمردگی	p ʒ m r d̪ g iː
پژوہش	p ʒ oː h ʃ
پکا	p k aː
پکار	p k aː r
پکنا	p k n aː
پھانسی	pʰ aː n s iː
پھدی	pʰ d̪ iː
پھریرے	pʰ r iː r eː
پھل	pʰ l
پھلنا	pʰ l n aː
پھول	pʰ oː l
پھوپھا	pʰ oː pʰ aː
پھوڑا	pʰ oː ɽ aː
پھیرا	pʰ iː r aː
پھیلاو	pʰ iː l aː oː
پھینکنا	pʰ iː n k n aː
پھینکنا	pʰ iː n k n aː
پہ	p h
پہاڑ	p h aː ɽ
پہلا	p h l aː
پہلوان	p h l oː aː n
پہنچنا	p h n t͡ʃ n aː
پہنچنا	p h n t͡ʃ n aː
پہچان	p h t͡ʃ aː n
پہیا	p h iː aː
پہیا	p h iː aː
پیادہ	p iː aː d̪ h
پیار	p iː aː r
پیار	p iː aː r
پیارا	p iː aː r aː
پیاز	p iː aː z
پیاس	p iː aː s
پیج	p iː d͡ʒ
پیدا	p iː d̪ aː
پیدائش	p iː d̪ aː iː ʃ
پیر	p iː r
پیر	p iː r
پیرس	p iː r s
پیرو	p iː r oː
پیرو	p iː r oː
پیروی	p iː r oː iː
پیش	p iː ʃ
پیشاب	p iː ʃ aː b
پیشگوئی	p iː ʃ g oː iː iː
پیغام	p iː ɣ aː m
پیغمبر	p iː ɣ m b r
پیمان	p iː m aː n
پینا	p iː n aː
پینسل	p iː n s l
پیٹ	p iː ʈ
پیڑ	p iː ɽ
چ	t͡ʃ
چ	t͡ʃ
چا	t͡ʃ aː
چائے	t͡ʃ aː iː eː
چابھی	t͡ʃ aː bʰ iː
چابی	t͡ʃ aː b iː
چادر	t͡ʃ aː d̪ r
چار	t͡ʃ aː r
چارسدہ	t͡ʃ aː r s d̪ h
چاشت	t͡ʃ aː ʃ t̪
چاشنی	t͡ʃ aː ʃ n iː
چاق	t͡ʃ aː q
چاقو	t͡ʃ aː q oː
چال	t͡ʃ aː l
چالک	t͡ʃ aː l k
چاند	t͡ʃ aː n d̪
چاند	t͡ʃ aː n d̪
چاندی	t͡ʃ aː n d̪ iː
چاندی	t͡ʃ aː n d̪ iː
چانٹا	t͡ʃ aː n ʈ aː
چاول	t͡ʃ aː oː l
چاٹ	t͡ʃ aː ʈ
چاٹنا	t͡ʃ aː ʈ n aː
چاٹگام	t͡ʃ aː ʈ g aː m
چاک	t͡ʃ aː k
چاہت	t͡ʃ aː h t̪
چاہنا	t͡ʃ aː h n aː
چاہے	t͡ʃ aː h eː
چای	t͡ʃ aː iː
چتکان	t͡ʃ t̪ k aː n
چراغ	t͡ʃ r aː ɣ
چراغ	t͡ʃ r aː ɣ
چراک	t͡ʃ r aː k
چربی	t͡ʃ r b iː
چرخہ	t͡ʃ r x h
چرس	t͡ʃ r s
چرپرا	t͡ʃ r p r aː
چرچ	t͡ʃ r t͡ʃ
چشتیاں	t͡ʃ ʃ t̪ iː aː n
چشم	t͡ʃ ʃ m
چشمک	t͡ʃ ʃ m k
چشمہ	t͡ʃ ʃ m h
چغتائی	t͡ʃ ɣ t̪ aː iː iː
چفتی	t͡ʃ f t̪ iː
چق	t͡ʃ q
چقماق	t͡ʃ q m aː q
چقمق	t͡ʃ q m q
چكی	t͡ʃ ? iː
چلاس	t͡ʃ l aː s
چلانا	t͡ʃ l aː n aː
چلانا	t͡ʃ l aː n aː
چلاہٹ	t͡ʃ l aː h ʈ
چلن	t͡ʃ l n
چلنا	t͡ʃ l n aː
چلون	t͡ʃ l oː n
چلچتر	t͡ʃ l t͡ʃ t̪ r
چماٹ	t͡ʃ m aː ʈ
چمن	t͡ʃ m n
چمو	t͡ʃ m oː
چمچ	t͡ʃ m t͡ʃ
چمچہ	t͡ʃ m t͡ʃ h
چمکار	t͡ʃ m k aː r
چنئی	t͡ʃ n iː iː
چناب	t͡ʃ n aː b
چنتا	t͡ʃ n t̪ aː
چندر	t͡ʃ n d̪ r
چندربند	t͡ʃ n d̪ r b n d̪
چنگال	t͡ʃ n g aː l
چنیوٹ	t͡ʃ n iː oː ʈ
چوبے	t͡ʃ oː b eː
چوت	t͡ʃ oː t̪
چوتر	t͡ʃ oː t̪ r
چوتڑ	t͡ʃ oː t̪ ɽ
چوتھا	t͡ʃ oː t̪ʰ aː
چوتھائی	t͡ʃ oː t̪ʰ aː iː iː
چود	t͡ʃ oː d̪
چودنا	t͡ʃ oː d̪ n aː
چودہ	t͡ʃ oː d̪ h
چودہ	t͡ʃ oː d̪ h
چور	t͡ʃ oː r
چورنگی	t͡ʃ oː r n g iː
چوری	t͡ʃ oː r iː
چول	t͡ʃ oː l
چولھا	t͡ʃ oː l h aː
چولھا	t͡ʃ oː l h aː
چومنا	t͡ʃ oː m n aː
چونا	t͡ʃ oː n aː
چوٹ	t͡ʃ oː ʈ
چوپان	t͡ʃ oː p aː n
چوپان	t͡ʃ oː p aː n
چوپان	t͡ʃ oː p aː n
چوڑا	t͡ʃ oː ɽ aː
چوڑائی	t͡ʃ oː ɽ aː iː iː
چوڑی	t͡ʃ oː ɽ iː
چوک	t͡ʃ oː k
چوکی	t͡ʃ oː k iː
چوکیدار	t͡ʃ oː k iː d̪ aː r
چوگنا	t͡ʃ oː g n aː
چوہا	t͡ʃ oː h aː
چٹکی	t͡ʃ ʈ k iː
چٹکی	t͡ʃ ʈ k iː
چٹگاؤں	t͡ʃ ʈ g aː oː n
چپ	t͡ʃ p
چپاتی	t͡ʃ p aː t̪ iː
چپقلش	t͡ʃ p q l ʃ
چپل	t͡ʃ p l
چپٹی	t͡ʃ p ʈ iː
چچی	t͡ʃ t͡ʃ iː
چڑھانا	t͡ʃ ɽ h aː n aː
چڑھنا	t͡ʃ ɽ h n aː
چڑیا	t͡ʃ ɽ iː aː
چڑیل	t͡ʃ ɽ iː l
چڑیل	t͡ʃ ɽ iː l
چکت	t͡ʃ k t̪
چکمہ	t͡ʃ k m h
چکنا	t͡ʃ k n aː
چکنا	t͡ʃ k n aː
چکنا	t͡ʃ k n aː
چکنگنیا	t͡ʃ k n g n iː aː
چکوال	t͡ʃ k oː aː l
چکھنا	t͡ʃ kʰ n aː
چگونہ	t͡ʃ g oː n h
چھ	t͡ʃʰ
چھاؤنی	t͡ʃʰ aː oː n iː
چھاؤں	t͡ʃʰ aː oː n
چھاتر	t͡ʃʰ aː t̪ r
چھال	t͡ʃʰ aː l
چھاپنا	t͡ʃʰ aː p n aː
چھاپہ	t͡ʃʰ aː p h
چھایا	t͡ʃʰ aː iː aː
چھت	t͡ʃʰ t̪
چھتری	t͡ʃʰ t̪ r iː
چھلانگ	t͡ʃʰ l aː n g
چھلکا	t͡ʃʰ l k aː
چھوارے	t͡ʃʰ oː aː r eː
چھونا	t͡ʃʰ oː n aː
چھوٹ	t͡ʃʰ oː ʈ
چھوٹا	t͡ʃʰ oː ʈ aː
چھوٹنا	t͡ʃʰ oː ʈ n aː
چھٹا	t͡ʃʰ ʈ aː
چھٹا	t͡ʃʰ ʈ aː
چھٹپٹانا	t͡ʃʰ ʈ p ʈ aː n aː
چھٹی	t͡ʃʰ ʈ iː
چھپانا	t͡ʃʰ p aː n aː
چھپنا	t͡ʃʰ p n aː
چھپکلی	t͡ʃʰ p k l iː
چھڑکاؤ	t͡ʃʰ ɽ k aː oː
چھکا	t͡ʃʰ k aː
چھہ	t͡ʃʰ h
چھینک	t͡ʃʰ iː n k
چہارم	t͡ʃ h aː r m
چہرہ	t͡ʃ h r h
چہرہ	t͡ʃ h r h
چیخ	t͡ʃ iː x
چیز	t͡ʃ iː z
چیل	t͡ʃ iː l
چیلینجی	t͡ʃ iː l iː n d͡ʒ iː
چین	t͡ʃ iː n
چین	t͡ʃ iː n
چین	t͡ʃ iː n
چینٹی	t͡ʃ iː n ʈ iː
چینٹی	t͡ʃ iː n ʈ iː
چینی	t͡ʃ iː n iː
چیونٹی	t͡ʃ iː oː n ʈ iː
چیونٹی	t͡ʃ iː oː n ʈ iː
چیچنیا	t͡ʃ iː t͡ʃ n iː aː
چیچنیا	t͡ʃ iː t͡ʃ n iː aː
ڈ	ɖ
ڈ	ɖ
ڈالنا	ɖ aː l n aː
ڈاڈو	ɖ aː ɖ oː
ڈاک	ɖ aː k
ڈاکو	ɖ aː k oː
ڈاکٹر	ɖ aː k ʈ r
ڈاکیہ	ɖ aː k iː h
ڈبہ	ɖ b h
ڈبہ	ɖ b h
ڈرنا	ɖ r n aː
ڈسکہ	ɖ s k h
ڈمبوداس	ɖ m b oː d̪ aː s
ڈمرو	ɖ m r oː
ڈنکرک	ɖ n k r k
ڈنکی	ɖ n k iː
ڈوری	ɖ oː r iː
ڈونگا	ɖ oː n g aː
ڈوور	ɖ oː oː r
ڈچ	ɖ t͡ʃ
ڈڑھیل	ɖ ɽ h iː l
ڈکار	ɖ k aː r
ڈکار	ɖ k aː r
ڈکی	ɖ k iː
ڈگمگانا	ɖ g m g aː n aː
ڈگی	ɖ g iː
ڈھانپنا	ɖʰ aː n p n aː
ڈھانچہ	ɖʰ aː n t͡ʃ h
ڈھاکہ	ɖʰ aː k h
ڈھول	ɖʰ oː l
ڈھولک	ɖʰ oː l k
ڈھونڈنا	ɖʰ oː n ɖ n aː
ڈھونڈھ	ɖʰ oː n ɖʰ
ڈھيٹ	ɖʰ iː ʈ
ڈھکن	ɖʰ k n
ڈہرکی	ɖ h r k iː
ڈیرہ	ɖ iː r h
ڈیوڑھی	ɖ iː oː ɽ h iː
ڈیٹابیس	ɖ iː ʈ aː b iː s
ڈیٹھ	ɖ iː ʈʰ
ڑ	ɽ
ڑ	ɽ
ژ	ʒ
ژ	ʒ
ژالہ	ʒ aː l h
ژوب	ʒ oː b
ژیان	ʒ iː aː n
ژیاں	ʒ iː aː n
ک	k
ک	k
کائنات	k aː iː n aː t̪
کابل	k aː b l
کابوس	k aː b oː s
کاتھولک	k aː t̪ʰ oː l k
کارا	k aː r aː
کارخانہ	k aː r x aː n h
کارروائی	k aː r r oː aː iː iː
کارزار	k aː r z aː r
کارن	k aː r n
کاروبار	k aː r oː b aː r
کارٹون	k aː r ʈ oː n
کارکردگی	k aː r k r d̪ g iː
کاشغر	k aː ʃ ɣ r
کاغذ	k aː ɣ z
کاغذات	k aː ɣ z aː t̪
کالا	k aː l aː
کالج	k aː l d͡ʒ
کالسروئے	k aː l s r oː iː eː
کام	k aː m
کامل	k aː m l
کامونکے	k aː m oː n k eː
کامیاب	k aː m iː aː b
کان	k aː n
کانٹا	k aː n ʈ aː
کانپنا	k aː n p n aː
کاویہ	k aː oː iː h
کاڑھا	k aː ɽ h aː
کاہکشان	k aː h k ʃ aː n
کب	k b
کبابیر	k b aː b iː r
کباڑ	k b aː ɽ
کبج	k b d͡ʒ
کبریت	k b r iː t̪
کبل	k b l
کبھو	k bʰ oː
کبھی	k bʰ iː
کبیر	k b iː r
کتا	k t̪ aː
کتاب	k t̪ aː b
کتراپی	k t̪ r aː p iː
کتره	k t̪ r ?
کتھن	k t̪ʰ n
کتی	k t̪ iː
کثرت	k s r t̪
کدو	k d̪ oː
کدو	k d̪ oː
کر	k r
کراچوی	k r aː t͡ʃ oː iː
کراچی	k r aː t͡ʃ iː
کردستان	k r d̪ s t̪ aː n
کردن	k r d̪ n
کردنت	k r d̪ n t̪
کرسی	k r s iː
کرشمہ	k r ʃ m h
کرغیزستان	k r ɣ iː z s t̪ aː n
کرم	k r m
کرن	k r n
کرنا	k r n aː
کرناٹک	k r n aː ʈ k
کرو	k r oː
کرو	k r oː
کروانا	k r oː aː n aː
کرکٹ	k r k ʈ
کرکٹ	k r k ʈ
کری	k r iː
کریم	k r iː m
کس	k s
کسان	k s aː n
کسی	k s iː
کشتی	k ʃ t̪ iː
کشتی	k ʃ t̪ iː
کشدھا	k ʃ d̪ʰ aː
کشما	k ʃ m aː
کشمیر	k ʃ m iː r
کشندہ	k ʃ n d̪ h
کشور	k ʃ oː r
کشور	k ʃ oː r
کشور	k ʃ oː r
کشٹ	k ʃ ʈ
کشیدگی	k ʃ iː d̪ g iː
کعبہ	k ʔ b h
کلاشنکوف	k l aː ʃ n k oː f
کلام	k l aː m
کلاونت	k l aː oː n t̪
کلاں	k l aː n
کلب	k l b
کلب	k l b
کلمہ	k l m h
کلو	k l oː
کلیان	k l iː aː n
کلیجا	k l iː d͡ʒ aː
کلیسیا	k l iː s iː aː
کلیہ	k l iː h
کلیہ	k l iː h
کم	k m
کمائی	k m aː iː iː
کمال	k m aː l
کمالیہ	k m aː l iː h
کمان	k m aː n
کمانا	k m aː n aː
کمبل	k m b l
کمبوڈیا	k m b oː ɖ iː aː
کمر	k m r
کمرہ	k m r h
کمری	k m r iː
کمل	k m l
کملا	k m l aː
کملائی	k m l aː iː iː
کمپ	k m p
کمپت	k m p t̪
کمپن	k m p n
کمپیوٹر	k m p iː oː ʈ r
کمھڑا	k m h ɽ aː
کمھڑا	k m h ɽ aː
کمی	k m iː
کمیاب	k m iː aː b
کمینہ	k m iː n h
کمیٹی	k m iː ʈ iː
کنارہ	k n aː r h
کنجی	k n d͡ʒ iː
کندرا	k n d̪ r aː
کندھا	k n d̪ʰ aː
کنعان	k n ʔ aː n
کنفیوشس	k n f iː oː ʃ s
کنواری	k n oː aː r iː
کنور	k n oː r
کنور	k n oː r
کنور	k n oː r
کنٹرول	k n ʈ r oː l
کنڑ	k n ɽ
کنکال	k n k aː l
کنگارو	k n g aː r oː
کنگھی	k n gʰ iː
کنیز	k n iː z
کنیسہ	k n iː s h
کو	k oː
کوئٹہ	k oː iː ʈ h
کوئی	k oː iː iː
کوا	k oː aː
کوا	k oː aː
کوتا	k oː t̪ aː
کورو	k oː r oː
کورو	k oː r oː
کوشش	k oː ʃ ʃ
کوفی	k oː f iː
کوفی	k oː f iː
کولر	k oː l r
کولمبیا	k oː l m b iː aː
کولن	k oː l n
کون	k oː n
کوٹری	k oː ʈ r iː
کوٹھی	k oː ʈʰ iː
کوکب	k oː k b
کوہ	k oː h
کوہاٹ	k oː h aː ʈ
کوہرا	k oː h r aː
کوہلو	k oː h l oː
کویت	k oː iː t̪
کویت	k oː iː t̪
کویت	k oː iː t̪
کٹھور	k ʈʰ oː r
کٹی	k ʈ iː
کپاس	k p aː s
کپاسی	k p aː s iː
کپتان	k p t̪ aː n
کپوت	k p oː t̪
کپڑا	k p ɽ aː
کچا	k t͡ʃ aː
کچھ	k t͡ʃʰ
کژدم	k ʒ d̪ m
ککش	k k ʃ
کھاتا	kʰ aː t̪ aː
کھاتوں	kʰ aː t̪ oː n
کھاتے	kʰ aː t̪ eː
کھاد	kʰ aː d̪
کھان	kʰ aː n
کھانا	kʰ aː n aː
کھانگ	kʰ aː n g
کھانگ	kʰ aː n g
کھانی	kʰ aː n iː
کھاگ	kʰ aː g
کھجلی	kʰ d͡ʒ l iː
کھجلی	kʰ d͡ʒ l iː
کھجور	kʰ d͡ʒ oː r
کھدیوت	kʰ d̪ iː oː t̪
کھر	kʰ r
کھرجو	kʰ r d͡ʒ oː
کھرنا	kʰ r n aː
کھسرا	kʰ s r aː
کھلنا	kʰ l n aː
کھلنا	kʰ l n aː
کھلونا	kʰ l oː n aː
کھنن	kʰ n n
کھنک	kʰ n k
کھنکنا	kʰ n k n aː
کھوٹا	kʰ oː ʈ aː
کھٹا	kʰ ʈ aː
کھٹائی	kʰ ʈ aː iː iː
کھڈا	kʰ ɖ aː
کھڑا	kʰ ɽ aː
کھڑکی	kʰ ɽ k iː
کھڑی	kʰ ɽ iː
کھڑے	kʰ ɽ eː
کھیت	kʰ iː t̪
کھیرا	kʰ iː r aː
کھیل	kʰ iː l
کھیلا	kʰ iː l aː
کھیلنا	kʰ iː l n aː
کھینچنا	kʰ iː n t͡ʃ n aː
کھینچنا	kʰ iː n t͡ʃ n aː
کھینچنا	kʰ iː n t͡ʃ n aː
کہ	k h
کہ	k h
کہانی	k h aː n iː
کہاوت	k h aː oː t̪
کہاں	k h aː n
کہر	k h r
کہرا	k h r aː
کہنا	k h n aː
کہنی	k h n iː
کیا	k iː aː
کیا	k iː aː
کیتھولک	k iː t̪ʰ oː l k
کیرلا	k iː r l aː
کیسے	k iː s eː
کیش	k iː ʃ
کیف	k iː f
کیل	k iː l
کیل	k iː l
کیلئے	k iː l iː eː
کیلا	k iː l aː
کیلکولیٹر	k iː l k oː l iː ʈ r
کیلی	k iː l iː
کیلے	k iː l eː
کیمرہ	k iː m r h
کیمیا	k iː m iː aː
کیمیائی	k iː m iː aː iː iː
کینسر	k iː n s r
کینچلی	k iː n t͡ʃ l iː
کینڈی	k iː n ɖ iː
کینیا	k iː n iː aː
کینیڈا	k iː n iː ɖ aː
کیوبیک	k iː oː b iː k
کیول	k iː oː l
کیچڑ	k iː t͡ʃ ɽ
کیڑا	k iː ɽ aː
کیک	k iː k
کیکر	k iː k r
کے	k eː
گ	g
گ	g
گاؤں	g aː oː n
گاؤں	g aː oː n
گائے	g aː iː eː
گاتر	g aː t̪ r
گاجر	g aː d͡ʒ r
گال	g aː l
گالی	g aː l iː
گام	g aː m
گان	g aː n
گانا	g aː n aː
گانجا	g aː n d͡ʒ aː
گانو	g aː n oː
گانو	g aː n oː
گانو	g aː n oː
گانوں	g aː n oː n
گانوں	g aː n oː n
گانڈ	g aː n ɖ
گانڈو	g aː n ɖ oː
گانڈو	g aː n ɖ oː
گانے	g aː n eː
گاو	g aː oː
گاو	g aː oː
گاڑی	g aː ɽ iː
گایک	g aː iː k
گتا	g t̪ aː
گج	g d͡ʒ
گجرات	g d͡ʒ r aː t̪
گدا	g d̪ aː
گدگدانا	g d̪ g d̪ aː n aː
گدھ	g d̪ʰ
گدھا	g d̪ʰ aː
گذارنا	g z aː r n aː
گذراننا	g z r aː n n aː
گذرنا	g z r n aː
گرام	g r aː m
گرانا	g r aː n aː
گرج	g r d͡ʒ
گرجا	g r d͡ʒ aː
گرجنا	g r d͡ʒ n aː
گردن	g r d̪ n
گرز	g r z
گرم	g r m
گرم	g r m
گرما	g r m aː
گرمکھی	g r m kʰ iː
گرمیاں	g r m iː aː n
گرنا	g r n aː
گرنتھ	g r n t̪ʰ
گرو	g r oː
گروہ	g r oː h
گرڈ	g r ɖ
گرہن	g r h n
گزارش	g z aː r ʃ
گزارہ	g z aː r h
گفتار	g f t̪ aː r
گفتگو	g f t̪ g oː
گلاب	g l aː b
گلابی	g l aː b iː
گلاس	g l aː s
گلال	g l aː l
گلانی	g l aː n iː
گلشن	g l ʃ n
گلو	g l oː
گلو	g l oː
گلو	g l oː
گلگت	g l g t̪
گلہری	g l h r iː
گلی	g l iː
گلیل	g l iː l
گلیم	g l iː m
گم	g m
گمان	g m aː n
گمانا	g m aː n aː
گمبھیر	g m bʰ iː r
گمنام	g m n aː m
گناہ	g n aː h
گنبد	g n b d̪
گنبذ	g n b z
گنبھیر	g n bʰ iː r
گنت	g n t̪
گنتی	g n t̪ iː
گنجا	g n d͡ʒ aː
گندمی	g n d̪ m iː
گندگی	g n d̪ g iː
گندھک	g n d̪ʰ k
گندہ	g n d̪ h
گنی	g n iː
گنیش	g n iː ʃ
گوا	g oː aː
گوادر	g oː aː d̪ r
گوادر	g oː aː d̪ r
گوبھی	g oː bʰ iː
گوجرانوالہ	g oː d͡ʒ r aː n oː aː l h
گوجرہ	g oː d͡ʒ r h
گورا	g oː r aː
گورداسپور	g oː r d̪ aː s p oː r
گورستان	g oː r s t̪ aː n
گورمنٹ	g oː r m n ʈ
گورو	g oː r oː
گوزن	g oː z n
گوزن	g oː z n
گوزن	g oː z n
گوشت	g oː ʃ t̪
گول	g oː l
گولی	g oː l iː
گوٹھ	g oː ʈʰ
گوپن	g oː p n
گوگرد	g oː g r d̪
گٹار	g ʈ aː r
گٹھری	g ʈʰ r iː
گپ	g p
گڈا	g ɖ aː
گڑ	g ɽ
گڑھ	g ɽ h
گڑیا	g ɽ iː aː
گگن	g g n
گھاس	gʰ aː s
گھاو	gʰ aː oː
گھاٹا	gʰ aː ʈ aː
گھاٹا	gʰ aː ʈ aː
گھبرانا	gʰ b r aː n aː
گھر	gʰ r
گھرانا	gʰ r aː n aː
گھرنا	gʰ r n aː
گھریلو	gʰ r iː l oː
گھمنڈ	gʰ m n ɖ
گھنٹا	gʰ n ʈ aː
گھنٹہ	gʰ n ʈ h
گھنٹی	gʰ n ʈ iː
گھوش	gʰ oː ʃ
گھونسلہ	gʰ oː n s l h
گھونٹ	gʰ oː n ʈ
گھونٹ	gʰ oː n ʈ
گھوٹکی	gʰ oː ʈ k iː
گھوڑا	gʰ oː ɽ aː
گھٹنا	gʰ ʈ n aː
گھٹنا	gʰ ʈ n aː
گھڑی	gʰ ɽ iː
گھڑیال	gʰ ɽ iː aː l
گھی	gʰ iː
گہرا	g h r aː
گیا	g iː aː
گیت	g iː t̪
گیر	g iː r
گیزر	g iː z r
گیس	g iː s
گیسن	g iː s n
گیلا	g iː l aː
گیند	g iː n d̪
گینڈا	g iː n ɖ aː
گینڈا	g iː n ɖ aː
گیہوں	g iː h oː n
گے	g eː
ں	n
ھ	h
ھ	h
ہ	h
ہ	h
ہاتھ	h aː t̪ʰ
ہاتھی	h aː t̪ʰ iː
ہار	h aː r
ہارون	h aː r oː n
ہانک	h aː n k
ہانکنا	h aː n k n aː
ہاں	h aː n
ہتھیار	h t̪ʰ iː aː r
ہتھیلی	h t̪ʰ iː l iː
ہتیارا	h t̪ iː aː r aː
ہجوم	h d͡ʒ oː m
ہجے	h d͡ʒ eː
ہدایت	h d̪ aː iː t̪
ہرانا	h r aː n aː
ہرن	h r n
ہرنائی	h r n aː iː iː
ہریانہ	h r iː aː n h
ہسپانی	h s p aː n iː
ہسپانیہ	h s p aː n iː h
ہفتو	h f t̪ oː
ہفتوں	h f t̪ oː n
ہفتہ	h f t̪ h
ہفتے	h f t̪ eː
ہفوۃ	h f oː ?
ہل	h l
ہلسہ	h l s h
ہلو	h l oː
ہلکا	h l k aː
ہلکان	h l k aː n
ہم	h m
ہمارا	h m aː r aː
ہمالیہ	h m aː l iː h
ہماہمی	h m aː h m iː
ہمایوں	h m aː iː oː n
ہمت	h m t̪
ہمجنسیت	h m d͡ʒ n s iː t̪
ہمسفر	h m s f r
ہمیشگی	h m iː ʃ g iː
ہمیشہ	h m iː ʃ h
ہمیں	h m iː n
ہند	h n d̪
ہندو	h n d̪ oː
ہندوتوا	h n d̪ oː t̪ oː aː
ہندوتوا	h n d̪ oː t̪ oː aː
ہندوستان	h n d̪ oː s t̪ aː n
ہندوستان	h n d̪ oː s t̪ aː n
ہندوستانی	h n d̪ oː s t̪ aː n iː
ہندوستانی	h n d̪ oː s t̪ aː n iː
ہندوی	h n d̪ oː iː
ہندی	h n d̪ iː
ہندیہ	h n d̪ iː h
ہنزلو	h n z l oː
ہنسا	h n s aː
ہنساتمک	h n s aː t̪ m k
ہنسلو	h n s l oː
ہنسنا	h n s n aː
ہنسنا	h n s n aː
ہنسنا	h n s n aː
ہنڈی	h n ɖ iː
ہنگامی	h n g aː m iː
ہوا	h oː aː
ہوا	h oː aː
ہوائی	h oː aː iː iː
ہوتا	h oː t̪ aː
ہود	h oː d̪
ہوس	h oː s
ہوسیع	h oː s iː ʔ
ہوشنگ	h oː ʃ n g
ہوشیار	h oː ʃ iː aː r
ہوشیع	h oː ʃ iː ʔ
ہولی	h oː l iː
ہونا	h oː n aː
ہونٹ	h oː n ʈ
ہونٹ	h oː n ʈ
ہونٹھ	h oː n ʈʰ
ہوٹل	h oː ʈ l
ہوں	h oː n
ہچکنا	h t͡ʃ k n aː
ہچکی	h t͡ʃ k iː
ہڈی	h ɖ iː
ہکا	h k aː
ہیجڑا	h iː d͡ʒ ɽ aː
ہیر	h iː r
ہیرا	h iː r aː
ہیضہ	h iː zˤ h
ہیمبرگ	h iː m b r g
ہیمبرگ	h iː m b r g
ہیک	h iː k
ہیں	h iː n
ہے	h eː
ہے	h eː
ہے	h eː
ہے	h eː
ی	iː
ی	iː
ی	iː
ی	iː
یا	iː aː
یات	iː aː t̪
یاد	iː aː d̪
یار	iː aː r
یاسمین	iː aː s m iː n
یال	iː aː l
یاور	iː aː oː r
یت	iː t̪
یت	iː t̪
یتیم	iː t̪ iː m
یحیی	iː h iː iː
یخ	iː x
یدھ	iː d̪ʰ
یدھ	iː d̪ʰ
یرغمال	iː r ɣ m aː l
یرمیاہ	iː r m iː aː h
یروشلم	iː r oː ʃ l m
یروشلم	iː r oː ʃ l m
یروشلم	iː r oː ʃ l m
یزدان	iː z d̪ aː n
یزیدیت	iː z iː d̪ iː t̪
یسعیاہ	iː s ʔ iː aː h
یسوع	iː s oː ʔ
یعقوب	iː ʔ q oː b
یعنی	iː ʔ n iː
یقین	iː q iː n
یقینا	iː q iː n aː
یمن	iː m n
یمنا	iː m n aː
ین	iː n
یوحنا	iː oː h n aː
یورش	iː oː r ʃ
یوروپ	iː oː r oː p
یورپ	iː oː r p
یوسف	iː oː s f
یوغ	iː oː ɣ
یوغ	iː oː ɣ
یوم	iː oː m
یون	iː oː n
یونان	iː oː n aː n
یونانی	iː oː n aː n iː
یونس	iː oː n s
یوکرین	iː oː k r iː n
یوگدان	iː oː g d̪ aː n
یوگنڈا	iː oː g n ɖ aː
یوگیتو	iː oː g iː t̪ oː
یوگیہ	iː oː g iː h
یوں	iː oː n
یوں	iː oː n
یک	iː k
یکتا	iː k t̪ aː
یکم	iː k m
یکیدم	iː k iː d̪ m
یگانہ	iː g aː n h
یہ	iː h
یہاں	iː h aː n
یہود	iː h oː d̪
یہودنی	iː h oː d̪ n iː
یہودنی	iː h oː d̪ n iː
یہودی	iː h oː d̪ iː
یہودیت	iː h oː d̪ iː t̪
یہودیت	iː h oː d̪ iː t̪
یہودیہ	iː h oː d̪ iː h
ے	eː
ے	eː
