ء	ʔ
ء	ʔ
ء	ʔ
ء	ʔ
ء	ʔ
آئرلینڈ	ɑː ʔ r l iː n ɖ
آئی	ɑː ʔ iː
آئین	ɑː ʔ iː n
آئینہ	ɑː ʔ iː n h
آب	ɑː b
آباد	ɑː b a d
آبادانی	ɑː b a d a n iː
آبادی	ɑː b a d iː
آبدوز	ɑː b d uː z
آبشار	ɑː b ʃ a r
آبنائے	ɑː b n a ʔ eː
آبچین	ɑː b tʃ iː n
آبی	ɑː b iː
آتش	ɑː t ʃ
آتما	ɑː t m a
آتنکوادی	ɑː t n k uː a d iː
آج	ɑː dʒ
آخرت	ɑː x r t
آخری	ɑː x r iː
آخن	ɑː x n
آخور	ɑː x uː r
آداب	ɑː d a b
آدر	ɑː d r
آدم	ɑː d m
آدمی	ɑː d m iː
آدھا	ɑː d ʰ a
آدھنک	ɑː d ʰ n k
آذر	ɑː z r
آذربائیجان	ɑː z r b a ʔ iː dʒ a n
آرام	ɑː r a m
آربل	ɑː r b l
آرزو	ɑː r z uː
آرمبھ	ɑː r m b ʰ
آرمی	ɑː r m iː
آرمینیا	ɑː r m iː n iː a
آرمینیا	ɑː r m iː n iː a
آروپ	ɑː r uː p
آروگیہ	ɑː r uː ɡ iː h
آریامن	ɑː r iː a m n
آریہ	ɑː r iː h
آرے	ɑː r eː
آزاد	ɑː z a d
آزادی	ɑː z a d iː
آزمائش	ɑː z m a ʔ ʃ
آزمانا	ɑː z m a n a
آزمودگی	ɑː z m uː d ɡ iː
آزمودہ	ɑː z m uː d h
آس	ɑː s
آسام	ɑː s a m
آسامی	ɑː s a m iː
آسان	ɑː s a n
آسان	ɑː s a n
آسانی	ɑː s a n iː
آستھا	ɑː s t ʰ a
آستین	ɑː s t iː n
آسرا	ɑː s r a
آسمان	ɑː s m a n
آسمانی	ɑː s m a n iː
آسن	ɑː s n
آسند	ɑː s n d
آسٹریا	ɑː s ʈ r iː a
آسٹریلیا	ɑː s ʈ r iː l iː a
آسکت	ɑː s k t
آسکول	ɑː s k uː l
آسیب	ɑː s iː b
آشچریہ	ɑː ʃ tʃ r iː h
آشیرواد	ɑː ʃ iː r uː a d
آغا	ɑː ɣ a
آغاز	ɑː ɣ a z
آغوش	ɑː ɣ uː ʃ
آفت	ɑː f t
آفتاب	ɑː f t a b
آفتابی	ɑː f t a b iː
آفریدی	ɑː f r iː d iː
آفرین	ɑː f r iː n
آقا	ɑː q a
آقچہ	ɑː q tʃ h
آلس	ɑː l s
آلسی	ɑː l s iː
آلنگن	ɑː l n ɡ n
آلو	ɑː l uː
آلود	ɑː l uː d
آلودگی	ɑː l uː d ɡ iː
آلودہ	ɑː l uː d h
آلوچنا	ɑː l uː tʃ n a
آلچی	ɑː l tʃ iː
آلہ	ɑː l h
آم	ɑː m
آمر	ɑː m r
آمریت	ɑː m r iː t
آمنہ	ɑː m n h
آموختہ	ɑː m uː x t h
آمود	ɑː m uː d
آموزش	ɑː m uː z ʃ
آمیزش	ɑː m iː z ʃ
آنا	ɑː n a
آندھی	ɑː n d ʰ iː
آنسو	ɑː n s uː
آنسو	ɑː n s uː
آنکھ	ɑː n k ʰ
آنکھ	ɑː n k ʰ
آنکھو	ɑː n k ʰ uː
آنکھوں	ɑː n k ʰ uː ŋ
آنکھیں	ɑː n k ʰ iː ŋ
آنگن	ɑː n ɡ n
آواران	ɑː ʋ a r a n
آوارہ	ɑː ʋ a r h
آواز	ɑː ʋ a z
آوشيکتا	ɑː ʋ ʃ k t a
آٹا	ɑː ʈ a
آٹھ	ɑː ʈ ʰ
آٹھواں	ɑː ʈ ʰ uː a ŋ
آٹھواں	ɑː ʈ ʰ uː a ŋ
آپ	ɑː p
آپا	ɑː p a
آپی	ɑː p iː
آچار	ɑː tʃ a r
آڑو	ɑː ɽ uː
آکاش	ɑː k a ʃ
آکاشی	ɑː k a ʃ iː
آکرشت	ɑː k r ʃ t
آکرمن	ɑː k r m n
آکھیٹ	ɑː k ʰ iː ʈ
آگ	ɑː ɡ
آگار	ɑː ɡ a r
آگرہ	ɑː ɡ r h
آگھات	ɑː ɡ ʰ a t
آگے	ɑː ɡ eː
آہ	ɑː h
آہستہ	ɑː h s t h
آہو	ɑː h uː
آیا	ɑː j a
آیت	ɑː j t
ا	a
ا	a
ا	a
ا	a
ابابیل	a b a b iː l
اباضی	a b a z iː
ابال	a b a l
ابالنا	a b a l n a
ابتدا	a b t d a
ابتدائی	a b t d a ʔ iː
ابتسام	a b t s a m
ابدا	a b d a
ابراہیم	a b r a h iː m
ابرق	a b r q
ابرنجن	a b r n dʒ n
ابرنجین	a b r n dʒ iː n
ابریق	a b r iː q
ابلق	a b l q
ابلنا	a b l n a
ابلیس	a b l iː s
ابلیسیانہ	a b l iː s iː a n h
ابن	a b n
ابنہ	a b n h
ابو	a b uː
ابٹن	a b ʈ n
ابکائی	a b k a ʔ iː
ابھار	a b ʰ a r
ابھاو	a b ʰ a ʋ
ابھرتا	a b ʰ r t a
ابھشیک	a b ʰ ʃ iː k
ابھمان	a b ʰ m a n
ابھی	a b ʰ iː
ابھی	a b ʰ iː
ابہام	a b h a m
اتارنا	a t a r n a
اتاق	a t a q
اتالیق	a t a l iː q
اتحاد	a t h a d
اتحاد	a t h a d
اتحادی	a t h a d iː
اترنا	a t r n a
اتصال	a t s a l
اتفاق	a t f a q
اتفاقا	a t f a q a
اتم	a t m
اتمام	a t m a m
اتمک	a t m k
اتوار	a t uː a r
اتھان	a t ʰ a n
اتہاس	a t h a s
اتہام	a t h a m
اتیاچاری	a t iː a tʃ a r iː
اثاث	a s a s
اثبات	a s b a t
اثر	a s r
اثنا	a s n a
اجازت	a dʒ a z t
اجالا	a dʒ a l a
اجالنا	a dʒ a l n a
اجتماع	a dʒ t m a ʔ
اجر	a dʒ r
اجرا	a dʒ r a
اجرت	a dʒ r t
اجزا	a dʒ z a
اجل	a dʒ l
اجلاس	a dʒ l a s
اجمالی	a dʒ m a l iː
اجنبی	a dʒ n b iː
اجوائن	a dʒ uː a ʔ n
اجگر	a dʒ ɡ r
اجی	a dʒ iː
احباب	a h b a b
احتجاج	a h t dʒ a dʒ
احترام	a h t r a m
احترام	a h t r a m
احتمال	a h t m a l
احتیاج	a h t iː a dʒ
احساس	a h s a s
احسان	a h s a n
احشا	a h ʃ a
احمد	a h m d
احمق	a h m q
احوال	a h uː a l
احیا	a h iː a
احیا	a h iː a
اخاہ	a x a h
اخبار	a x b a r
اختلاف	a x t l a f
اختہ	a x t h
اختیار	a x t iː a r
اختیاری	a x t iː a r iː
اخذ	a x z
اخروٹ	a x r uː ʈ
اخلاط	a x l a t
اخلاق	a x l a q
اخلاق	a x l a q
ادا	a d a
ادائیگی	a d a ʔ iː ɡ iː
ادارتی	a d a r t iː
ادارہ	a d a r h
اداری	a d a r iː
اداس	a d a s
اداسی	a d a s iː
اداہرن	a d a h r n
ادب	a d b
ادبا	a d b a
ادبی	a d b iː
ادبیات	a d b iː a t
ادرنہ	a d r n h
ادرک	a d r k
ادریس	a d r iː s
اديان	a d a n
ادھار	a d ʰ a r
ادھلنا	a d ʰ l n a
ادھماس	a d ʰ m a s
ادھورا	a d ʰ uː r a
ادھکار	a d ʰ k a r
ادھکاری	a d ʰ k a r iː
ادھیڑ	a d ʰ iː ɽ
ادہم	a d h m
ادیب	a d iː b
ادیہ	a d iː h
اذن	a z n
اذیت	a z iː t
ارب	a r b
ارتعاش	a r t ʔ a ʃ
ارتھ	a r t ʰ
ارجت	a r dʒ t
ارجن	a r dʒ n
ارجن	a r dʒ n
ارجنٹائن	a r dʒ n ʈ a ʔ n
اردلی	a r d l iː
اردن	a r d n
اردو	a r d uː
ارز	a r z
ارسطو	a r s t uː
ارش	a r ʃ
ارض	a r z
ارغوانی	a r ɣ uː a n iː
ارمان	a r m a n
ارمنستان	a r m n s t a n
ارمیا	a r m iː a
ارے	a r eː
از	a z
ازبک	a z b k
ازبکستان	a z b k s t a n
ازدواج	a z d uː a dʒ
اساس	a s a s
اساس	a s a s
اساسی	a s a s iː
اسباب	a s b a b
استاد	a s t a d
استبداد	a s t b d a d
استخلاف	a s t x l a f
استخوان	a s t x uː a n
استر	a s t r
استری	a s t r iː
استری	a s t r iː
استری	a s t r iː
استعفی	a s t ʔ f iː
استعمال	a s t ʔ m a l
استقبال	a s t q b a l
استنبول	a s t n b uː l
استوار	a s t uː a r
استوار	a s t uː a r
استور	a s t uː r
استھ	a s t ʰ
اسحاق	a s h a q
اسرائیل	a s r a ʔ iː l
اسراف	a s r a f
اسلام	a s l a m
اسلامی	a s l a m iː
اسلحہ	a s l h h
اسلحہ	a s l h h
اسلوب	a s l uː b
اسم	a s m
اسم	a s m
اسماعیل	a s m a ʔ iː l
اسٹیشن	a s ʈ iː ʃ n
اسٹیڈیم	a s ʈ iː ɖ iː m
اسپ	a s p
اسپات	a s p a t
اسپتال	a s p t a l
اسپغول	a s p ɣ uː l
اسکول	a s k uː l
اسہال	a s h a l
اسیر	a s iː r
اسیری	a s iː r iː
اشارہ	a ʃ a r h
اشاعت	a ʃ a ʔ t
اشاعت	a ʃ a ʔ t
اشبھ	a ʃ b ʰ
اشبیلیہ	a ʃ b iː l iː h
اشتباہا	a ʃ t b a h a
اشتراک	a ʃ t r a k
اشتراکیت	a ʃ t r a k iː t
اشتقاق	a ʃ t q a q
اشتہا	a ʃ t h a
اشتہار	a ʃ t h a r
اشراق	a ʃ r a q
اشوک	a ʃ uː k
اشک	a ʃ k
اصطبل	a s t b l
اصطلاح	a s t l a h
اصغر	a s ɣ r
اصل	a s l
اصلاح	a s l a h
اصول	a s uː l
اصہار	a s h a r
اصیل	a s iː l
اضافہ	a z a f h
اضطراری	a z t r a r iː
اطالیہ	a t a l iː h
اطفال	a t f a l
اطلاع	a t l a ʔ
اطلاقی	a t l a q iː
اطلس	a t l s
اطمینان	a t m iː n a n
اعتبار	a ʔ t b a r
اعتراف	a ʔ t r a f
اعتماد	a ʔ t m a d
اعضا	a ʔ z a
اعضا	a ʔ z a
اعظم	a ʔ z m
اعلی	a ʔ l iː
اغوا	a ɣ uː a
اغوا	a ɣ uː a
افراد	a f r a d
افریقہ	a f r iː q h
افزائش	a f z a ʔ ʃ
افسانہ	a f s a n h
افطار	a f t a r
افطاری	a f t a r iː
افغان	a f ɣ a n
افغانستان	a f ɣ a n s t a n
افق	a f q
افلاس	a f l a s
اقامت	a q a m t
اقتدار	a q t d a r
اقتصادی	a q t s a d iː
اقلیت	a q l iː t
اقلیت	a q l iː t
اقلیم	a q l iː m
الائچی	a l a ʔ tʃ iː
البانیا	a l b a n iː a
البتہ	a l b t h
الجزائر	a l dʒ z a ʔ r
الحاق	a l h a q
الزام	a l z a m
اللہ	a l l h
اللہ	a l l h
الم	a l m
الماری	a l m a r iː
الماس	a l m a s
النکار	a l n k a r
النکرت	a l n k r t
الوداع	a l uː d a ʔ
الوداع	a l uː d a ʔ
الٹی	a l ʈ iː
الکحل	a l k h l
الگ	a l ɡ
الہام	a l h a m
الیاس	a l iː a s
الیسع	a l iː s ʔ
امارت	a m a r t
امام	a m a m
امانت	a m a n t
امتحان	a m t h a n
امداد	a m d a d
امر	a m r
امرا	a m r a
امرتسر	a m r t s r
امرود	a m r uː d
امروز	a m r uː z
امریکا	a m r iː k a
امریکہ	a m r iː k h
امل	a m l
املا	a m l a
امن	a m n
امور	a m uː r
امکان	a m k a n
امی	a m iː
امید	a m iː d
امید	a m iː d
امیدوار	a m iː d uː a r
امیدوار	a m iː d uː a r
امیر	a m iː r
امینہ	a m iː n h
اناتھ	a n a t ʰ
انار	a n a r
انارکلی	a n a r k l iː
انبار	a n b a r
انبیاء	a n b iː a ʔ
انت	a n t
انتباہ	a n t b a h
انتخاب	a n t x a b
انتخاب	a n t x a b
انتر	a n t r
انترم	a n t r m
انتظار	a n t z a r
انتظار	a n t z a r
انتظار	a n t z a r
انتظام	a n t z a m
انتظامی	a n t z a m iː
انتظامیہ	a n t z a m iː h
انتقال	a n t q a l
انتم	a n t m
انتہائی	a n t h a ʔ iː
انتہاپسند	a n t h a p s n d
انجام	a n dʒ a m
انجانا	a n dʒ a n a
انجیر	a n dʒ iː r
انداز	a n d a z
اندراج	a n d r a dʒ
اندلس	a n d l s
اندھا	a n d ʰ a
اندھکار	a n d ʰ k a r
اندھیرا	a n d ʰ iː r a
اندیکھا	a n d iː k ʰ a
انسان	a n s a n
انسانی	a n s a n iː
انش	a n ʃ
انصاف	a n s a f
انطاکیہ	a n t a k iː h
انطلیاس	a n t l iː a s
انعام	a n ʔ a m
انقلاب	a n q l a b
انقلاب	a n q l a b
انوادک	a n uː a d k
انوکھا	a n uː k ʰ a
انٹارکٹکا	a n ʈ a r k ʈ k a
انپم	a n p m
انچل	a n tʃ l
انڈا	a n ɖ a
انڈونیشیا	a n ɖ uː n iː ʃ iː a
انڈکوش	a n ɖ k uː ʃ
انڈیا	a n ɖ iː a
انکار	a n k a r
انکل	a n k l
انگریز	a n ɡ r iː z
انگریزی	a n ɡ r iː z iː
انگلستان	a n ɡ l s t a n
انگلی	a n ɡ l iː
انگلینڈ	a n ɡ l iː n ɖ
انگور	a n ɡ uː r
انگوری	a n ɡ uː r iː
انگولہ	a n ɡ uː l h
انگوٹھا	a n ɡ uː ʈ ʰ a
انگوٹھی	a n ɡ uː ʈ ʰ iː
انگھیٹی	a n ɡ ʰ iː ʈ iː
انھیں	a n ʰ iː ŋ
انھیں	a n ʰ iː ŋ
انہ	a n h
انہیں	a n h iː ŋ
انہیں	a n h iː ŋ
انیک	a n iː k
اوتھل	a ʋ t ʰ l
اودا	a ʋ d a
اودبلاؤ	a ʋ d b l a ʔ
اودھی	a ʋ d ʰ iː
اور	a ʋ r
اورماڑا	a ʋ r m a ɽ a
اورنگ	a ʋ r n ɡ
اورنگزیب	a ʋ r n ɡ z iː b
اوس	a ʋ s
اوساکا	a ʋ s a k a
اوسطا	a ʋ s t a
اوقات	a ʋ q a t
اول	a ʋ l
اولا	a ʋ l a
اولاد	a ʋ l a d
اولو	a ʋ l uː
اولی	a ʋ l iː
اولی	a ʋ l iː
اولی	a ʋ l iː
اونٹ	a ʋ n ʈ
اونچائی	a ʋ n tʃ a ʔ iː
اونگھ	a ʋ n ɡ ʰ
اوپر	a ʋ p r
اوڈیشہ	a ʋ ɖ iː ʃ h
اوڑی	a ʋ ɽ iː
اوکاش	a ʋ k a ʃ
اوکاڑہ	a ʋ k a ɽ h
اوکھی	a ʋ k ʰ iː
اوہ	a ʋ h
اویغور	a ʋ j ɣ uː r
اویغورستان	a ʋ j ɣ uː r s t a n
اٹاری	a ʈ a r iː
اٹاچی	a ʈ a tʃ iː
اٹاچی	a ʈ a tʃ iː
اٹک	a ʈ k
اٹھانا	a ʈ ʰ a n a
اپاسک	a p a s k
اپاہج	a p a h dʒ
اپبھوگ	a p b ʰ uː ɡ
اپدهان	a p d a n
اپدیش	a p d iː ʃ
اپرادھ	a p r a d ʰ
اپرادھی	a p r a d ʰ iː
اپرمپار	a p r m p a r
اپریل	a p r iː l
اپستھت	a p s t ʰ t
اپلبدھ	a p l b d ʰ
اپنا	a p n a
اپنيتر	a p n t r
اپہار	a p h a r
اپیوگ	a p iː ʋ ɡ
اچار	a tʃ a r
اچانک	a tʃ a n k
اچت	a tʃ t
اچکیریہ	a tʃ k iː r iː h
اچکیریہ	a tʃ k iː r iː h
اچھا	a tʃ ʰ a
اچھا	a tʃ ʰ a
اچھلنا	a tʃ ʰ l n a
اڑان	a ɽ a n
اڑانا	a ɽ a n a
اڑنا	a ɽ n a
اڑنا	a ɽ n a
اژدہا	a ʒ d h a
اک	a k
اکادمک	a k a d m k
اکادمی	a k a d m iː
اکال	a k a l
اکانوے	a k a n uː eː
اکتوبر	a k t uː b r
اکثر	a k s r
اکلوتا	a k l uː t a
اکنون	a k n uː n
اکھروٹ	a k ʰ r uː ʈ
اکیلا	a k iː l a
اکیلاپن	a k iː l a p n
اکیلے	a k iː l eː
اگر	a ɡ r
اگربتی	a ɡ r b t iː
اگرچہ	a ɡ r tʃ h
اگست	a ɡ s t
اگلا	a ɡ l a
اگنا	a ɡ n a
اگنی	a ɡ n iː
ایالت	a j a l t
ایت	a j t
ایتھنز	a j t ʰ n z
ایتھنز	a j t ʰ n z
ایتھوپیا	a j t ʰ uː p iː a
ایجنٹ	a j dʒ n ʈ
ایران	a j r a n
ایرانی	a j r a n iː
ایزد	a j z d
ایزد	a j z d
ایزد	a j z d
ایزد	a j z d
ایشور	a j ʃ uː r
ایلچی	a j l tʃ iː
ایمان	a j m a n
ایماندار	a j m a n d a r
اینٹ	a j n ʈ
ایواللہ	a j ʋ a l l h
ایوان	a j ʋ a n
ایوب	a j ʋ b
ایڈنبرا	a j ɖ n b r a
ایڈنبرا	a j ɖ n b r a
ایڈنبرا	a j ɖ n b r a
ایک	a j k
ب	b
ب	b
بائبل	b a ʔ b l
بائیسکل	b a ʔ iː s k l
بابو	b a b uː
بات	b a t
باتھروم	b a t ʰ r uː m
باجی	b a dʒ iː
باختر	b a x t r
باد	b a d
بادام	b a d a m
بادام	b a d a m
بادامی	b a d a m iː
بادشاہ	b a d ʃ a h
بادشاہت	b a d ʃ a h t
بادل	b a d l
بار	b a r
بارات	b a r a t
باراں	b a r a ŋ
بارش	b a r ʃ
بارکھان	b a r k ʰ a n
بارہا	b a r h a
باریک	b a r iː k
بازار	b a z a r
بازار	b a z a r
بازو	b a z uː
بازی	b a z iː
باشندہ	b a ʃ n d h
باعث	b a ʔ s
باغ	b a ɣ
باغی	b a ɣ iː
باغیچہ	b a ɣ iː tʃ h
باقی	b a q iː
بال	b a l
بالش	b a l ʃ
بالفعل	b a l f ʔ l
بالکل	b a l k l
باندھنا	b a n d ʰ n a
بانس	b a n s
بانسو	b a n s uː
بانسوں	b a n s uː ŋ
بانو	b a n uː
بانو	b a n uː
بانچنا	b a n tʃ n a
بانہو	b a n h uː
بانہوں	b a n h uː ŋ
بانہہ	b a n h h
بانہیں	b a n h iː ŋ
باورچی	b a ʋ r tʃ iː
باٹ	b a ʈ
باڑھ	b a ɽ ʰ
باکو	b a k uː
باہر	b a h r
باہر	b a h r
باہم	b a h m
باہمی	b a h m iː
باہوبلی	b a h uː b l iː
ببھکشا	b b ʰ k ʃ a
بت	b t
بتانا	b t a n a
بتانا	b t a n a
بجائے	b dʒ a ʔ eː
بجری	b dʒ r iː
بجلی	b dʒ l iː
بجے	b dʒ eː
بحال	b h a l
بحر	b h r
بحران	b h r a n
بحرین	b h r iː n
بحریہ	b h r iː h
بخش	b x ʃ
بدبو	b d b uː
بدبو	b d b uː
بددعا	b d d ʔ a
بدر	b d r
بدصورت	b d s uː r t
بدعنوانی	b d ʔ n uː a n iː
بدلنا	b d l n a
بدلوانا	b d l uː a n a
بدلہ	b d l h
بدن	b d n
بدنصیب	b d n s iː b
بدنیت	b d n iː t
بدولت	b d uː l t
بدھ	b d ʰ
بدھرتا	b d ʰ r t a
بدھوار	b d ʰ uː a r
بدھیا	b d ʰ iː a
بدیع	b d iː ʔ
بدیع	b d iː ʔ
بدین	b d iː n
برآمد	b r ɑː m d
برا	b r a
برات	b r a t
برازیل	b r a z iː l
برباد	b r b a d
برتن	b r t n
برج	b r dʒ
برس	b r s
برسات	b r s a t
برسلز	b r s l z
برسی	b r s iː
برصغیر	b r s ɣ iː r
برف	b r f
برق	b r q
برقع	b r q ʔ
برقی	b r q iː
برلن	b r l n
برما	b r m a
برمنگھم	b r m n ɡ ʰ m
بروخے	b r uː x eː
برودت	b r uː d t
برچھا	b r tʃ ʰ a
برچھیت	b r tʃ ʰ iː t
برکت	b r k t
برکها	b r k a
برگزیدہ	b r ɡ z iː d h
برہنہ	b r h n h
برہنہ	b r h n h
بریشال	b r iː ʃ a l
بزار	b z a r
بزرگ	b z r ɡ
بزرگی	b z r ɡ iː
بس	b s
بستر	b s t r
بستی	b s t iː
بسکٹ	b s k ʈ
بسیار	b s iː a r
بشیر	b ʃ iː r
بطخ	b t x
بظاہر	b z a h r
بعث	b ʔ s
بعد	b ʔ d
بعلبک	b ʔ l b k
بغاوت	b ɣ a ʋ t
بغل	b ɣ l
بغیر	b ɣ iː r
بغیچہ	b ɣ iː tʃ h
بقار	b q a r
بقر	b q r
بقرعید	b q r ʔ iː d
بقرعید	b q r ʔ iː d
بقرہ	b q r h
بلا	b l a
بلا	b l a
بلا	b l a
بلا	b l a
بلب	b l b
بلغاری	b l ɣ a r iː
بلغاریہ	b l ɣ a r iː h
بلغم	b l ɣ m
بلند	b l n d
بلوغت	b l uː ɣ t
بلوچستان	b l uː tʃ s t a n
بلکہ	b l k h
بلہار	b l h a r
بلی	b l iː
بلیدہ	b l iː d h
بم	b m
بمباری	b m b a r iː
بمبہ	b m b h
بمقابلہ	b m q a b l h
بمقابلہ	b m q a b l h
بمقابلہ	b m q a b l h
بنا	b n a
بنا	b n a
بنارس	b n a r s
بنانا	b n a n a
بناوٹ	b n a ʋ ʈ
بناوٹی	b n a ʋ ʈ iː
بنت	b n t
بنتی	b n t iː
بنجارا	b n dʒ a r a
بنجی	b n dʒ iː
بند	b n d
بندر	b n d r
بندوق	b n d uː q
بندوق	b n d uː q
بندھن	b n d ʰ n
بندہ	b n d h
بنزین	b n z iː n
بنفشی	b n f ʃ iː
بنيان	b n a n
بنگ	b n ɡ
بنگال	b n ɡ a l
بنگالی	b n ɡ a l iː
بنیادی	b n iː a d iː
بو	b uː
بو	b uː
بواب	b uː a b
بوتل	b uː t l
بوجھ	b uː dʒ ʰ
بودار	b uː d a r
بور	b uː r
بوریت	b uː r iː t
بوسنیا	b uː s n iː a
بوسہ	b uː s h
بولنا	b uː l n a
بولی	b uː l iː
بوم	b uː m
بونا	b uː n a
بونا	b uː n a
بونڈر	b uː n ɖ r
بوٹ	b uː ʈ
بوچڑ	b uː tʃ ɽ
بوڑھا	b uː ɽ ʰ a
بٹن	b ʈ n
بٹوا	b ʈ uː a
بٹوا	b ʈ uː a
بٹورنا	b ʈ uː r n a
بٹھانا	b ʈ ʰ a n a
بپتسمہ	b p t s m h
بچپن	b tʃ p n
بچھو	b tʃ ʰ uː
بچہ	b tʃ h
بچی	b tʃ iː
بڑا	b ɽ a
بڑھاپا	b ɽ ʰ a p a
بڑھنا	b ɽ ʰ n a
بکاؤ	b k a ʔ
بکاؤ	b k a ʔ
بکرا	b k r a
بکری	b k r iː
بکس	b k s
بکم	b k m
بکم	b k m
بکھراو	b k ʰ r a ʋ
بھائی	b ʰ a ʔ iː
بھاجن	b ʰ a dʒ n
بھارت	b ʰ a r t
بھاشا	b ʰ a ʃ a
بھالو	b ʰ a l uː
بھانجا	b ʰ a n dʒ a
بھانجی	b ʰ a n dʒ iː
بھانگ	b ʰ a n ɡ
بھاگ	b ʰ a ɡ
بھاگنا	b ʰ a ɡ n a
بھتیجا	b ʰ t iː dʒ a
بھتیجی	b ʰ t iː dʒ iː
بھراتا	b ʰ r a t a
بھرم	b ʰ r m
بھرن	b ʰ r n
بھرنا	b ʰ r n a
بھروسہ	b ʰ r uː s h
بھلوال	b ʰ l uː a l
بھلکڑ	b ʰ l k ɽ
بھنجک	b ʰ n dʒ k
بھوت	b ʰ uː t
بھوتنی	b ʰ uː t n iː
بھوتنی	b ʰ uː t n iː
بھورا	b ʰ uː r a
بھوسڑی	b ʰ uː s ɽ iː
بھولنا	b ʰ uː l n a
بھومی	b ʰ uː m iː
بھونیشور	b ʰ uː n iː ʃ uː r
بھوٹان	b ʰ uː ʈ a n
بھوک	b ʰ uː k
بھوگول	b ʰ uː ɡ uː l
بھکت	b ʰ k t
بھکتی	b ʰ k t iː
بھکر	b ʰ k r
بھگدڑ	b ʰ ɡ d ɽ
بھگوان	b ʰ ɡ uː a n
بھی	b ʰ iː
بھیا	b ʰ iː a
بھیانک	b ʰ iː a n k
بھیجنا	b ʰ iː dʒ n a
بھید	b ʰ iː d
بھیس	b ʰ iː s
بھیڑ	b ʰ iː ɽ
بھیڑ	b ʰ iː ɽ
بھیک	b ʰ iː k
بہ	b h
بہاؤالدین	b h a ʔ a l d iː n
بہادری	b h a d r iː
بہادری	b h a d r iː
بہار	b h a r
بہار	b h a r
بہاراں	b h a r a ŋ
بہاولنگر	b h a ʋ l n ɡ r
بہاولپور	b h a ʋ l p uː r
بہت	b h t
بہت	b h t
بہتر	b h t r
بہتر	b h t r
بہرا	b h r a
بہرام	b h r a m
بہرام	b h r a m
بہروز	b h r uː z
بہشت	b h ʃ t
بہن	b h n
بہن	b h n
بہنا	b h n a
بیت	b iː t
بیتا	b iː t a
بیجا	b iː dʒ a
بیجنگ	b iː dʒ n ɡ
بیخ	b iː x
بیخ	b iː x
بیدار	b iː d a r
بیر	b iː r
بیروت	b iː r uː t
بیزتی	b iː z t iː
بیزتی	b iː z t iː
بیستی	b iː s t iː
بیش	b iː ʃ
بیشک	b iː ʃ k
بیضہ	b iː z h
بیعت	b iː ʔ t
بیعت	b iː ʔ t
بیعت	b iː ʔ t
بیلاروس	b iː l a r uː s
بیلجیم	b iː l dʒ iː m
بیلہ	b iː l h
بیمار	b iː m a r
بیماری	b iː m a r iː
بینک	b iː n k
بیوی	b iː ʋ j
بیٹا	b iː ʈ a
بیٹھنا	b iː ʈ ʰ n a
بیٹھک	b iː ʈ ʰ k
بیچ	b iː tʃ
بیچنا	b iː tʃ n a
بیکر	b iː k r
بیگ	b iː ɡ
بیگ	b iː ɡ
بیگم	b iː ɡ m
بے	b eː
ت	t
ت	t
تابش	t a b ʃ
تابندہ	t a b n d h
تاج	t a dʒ
تاجکستان	t a dʒ k s t a n
تار	t a r
تارا	t a r a
تارکین	t a r k iː n
تاریخ	t a r iː x
تاریخچہ	t a r iː x tʃ h
تاریخی	t a r iː x iː
تاریک	t a r iː k
تاریکی	t a r iː k iː
تازہ	t a z h
تاش	t a ʃ
تاشقند	t a ʃ q n d
تال	t a l
تالا	t a l a
تالو	t a l uː
تالی	t a l iː
تاناشاہ	t a n a ʃ a h
تانبا	t a n b a
تاپنا	t a p n a
تاڑ	t a ɽ
تاڑی	t a ɽ iː
تاہم	t a h m
تب	t b
تبادلہ	t b a d l h
تبادلہ	t b a d l h
تبدیل	t b d iː l
تبریز	t b r iː z
تبصرہ	t b s r h
تتلی	t t l iː
تتکالین	t t k a l iː n
تجارتی	t dʒ a r t iː
تجاوز	t dʒ a ʋ z
تجربہ	t dʒ r b h
تجزیہ	t dʒ z iː h
تجھے	t dʒ ʰ eː
تحریک	t h r iː k
تحفظ	t h f z
تحفہ	t h f h
تحفہ	t h f h
تحقیق	t h q iː q
تخت	t x t
تختہ	t x t h
تخلیق	t x l iː q
تخم	t x m
تخمہ	t x m h
تخیل	t x iː l
ترازو	t r a z uː
ترانہ	t r a n h
تراویح	t r a ʋ j h
تربت	t r b t
ترجمان	t r dʒ m a n
ترجمہ	t r dʒ m h
ترجمہ	t r dʒ m h
ترجیح	t r dʒ iː h
ترجیح	t r dʒ iː h
ترس	t r s
ترقی	t r q iː
ترقی	t r q iː
ترٹی	t r ʈ iː
ترک	t r k
ترکستان	t r k s t a n
ترکی	t r k iː
ترکیہ	t r k iː h
ترکیے	t r k iː eː
تریپورہ	t r iː p uː r h
تسلیم	t s l iː m
تشریح	t ʃ r iː h
تشنہ	t ʃ n h
تشویشناک	t ʃ uː j ʃ n a k
تشکیل	t ʃ k iː l
تصاویر	t s a ʋ j r
تصدیق	t s d iː q
تصور	t s uː r
تصویر	t s uː j r
تصویرو	t s uː j r uː
تصویروں	t s uː j r uː ŋ
تصویریں	t s uː j r iː ŋ
تعارف	t ʔ a r f
تعارف	t ʔ a r f
تعداد	t ʔ d a d
تعداد	t ʔ d a d
تعریف	t ʔ r iː f
تعلق	t ʔ l q
تعلق	t ʔ l q
تعلیم	t ʔ l iː m
تغافل	t ɣ a f l
تغییر	t ɣ iː j r
تفاح	t f a h
تفصیل	t f s iː l
تفنگ	t f n ɡ
تقدیر	t q d iː r
تقریبا	t q r iː b a
تقلید	t q l iː d
تلا	t l a
تلا	t l a
تلاوت	t l a ʋ t
تلخ	t l x
تلخ	t l x
تلخی	t l x iː
تلسی	t l s iː
تلفظ	t l f z
تلوار	t l uː a r
تم	t m
تماشہ	t m a ʃ h
تمام	t m a m
تمرکز	t m r k z
تمغا	t m ɣ a
تملق	t m l q
تمنا	t m n a
تمنچہ	t m n tʃ h
تمپ	t m p
تمھارا	t m ʰ a r a
تمھیں	t m ʰ iː ŋ
تمہارا	t m h a r a
تمہیں	t m h iː ŋ
تمیز	t m iː z
تن	t n
تنازع	t n a z ʔ
تنبولی	t n b uː l iː
تندر	t n d r
تندر	t n d r
تندر	t n d r
تندرست	t n d r s t
تندرستی	t n d r s t iː
تندور	t n d uː r
تنزانیہ	t n z a n iː h
تنظیم	t n z iː m
تنظیمی	t n z iː m iː
تنقید	t n q iː d
تنگ	t n ɡ
تنہائی	t n h a ʔ iː
تو	t uː
تو	t uː
توبہ	t uː b h
توبہ	t uː b h
توجہ	t uː dʒ h
توحید	t uː h iː d
تودہ	t uː d h
تودہ	t uː d h
توران	t uː r a n
توقع	t uː q ʔ
تولد	t uː l d
تولیہ	t uː l iː h
تولیہ	t uː l iː h
تولیے	t uː l iː eː
توچا	t uː tʃ a
توڑنا	t uː ɽ n a
توہین	t uː h iː n
تڑت	t ɽ t
تکبر	t k b r
تکبیر	t k b iː r
تکلیف	t k l iː f
تکمیل	t k m iː l
تکھان	t k ʰ a n
تکیہ	t k iː h
تکیہ	t k iː h
تگنا	t ɡ n a
تھائیلینڈ	t ʰ a ʔ iː l iː n ɖ
تھوک	t ʰ uː k
تھوکنا	t ʰ uː k n a
تہ	t h
تہائی	t h a ʔ iː
تہجد	t h dʒ d
تہجی	t h dʒ iː
تہذیب	t h z iː b
تہوار	t h uː a r
تہہ	t h h
تیار	t iː a r
تیاری	t iː a r iː
تیاگ	t iː a ɡ
تیرا	t iː r a
تیراک	t iː r a k
تیراکوں	t iː r a k uː ŋ
تیرنا	t iː r n a
تیز	t iː z
تیزاب	t iː z a b
تیسرا	t iː s r a
تیل	t iː l
تیمور	t iː m uː r
تین	t iː n
تیکھا	t iː k ʰ a
ث	s
ث	s
ثابت	s a b t
ثانیہ	s a n iː h
ثبوت	s b uː t
ثروت	s r uː t
ثقافت	s q a f t
ثقالت	s q a l t
ثم	s m
ثواب	s uː a b
ثورہ	s uː r h
ج	dʒ
ج	dʒ
جائداد	dʒ a ʔ d a d
جائداد	dʒ a ʔ d a d
جائزہ	dʒ a ʔ z h
جائپھل	dʒ a ʔ p ʰ l
جادو	dʒ a d uː
جادوگر	dʒ a d uː ɡ r
جارجیا	dʒ a r dʒ iː a
جال	dʒ a l
جالندھر	dʒ a l n d ʰ r
جام	dʒ a m
جامعہ	dʒ a m ʔ h
جامعہ	dʒ a m ʔ h
جامن	dʒ a m n
جامن	dʒ a m n
جامنی	dʒ a m n iː
جان	dʒ a n
جاننا	dʒ a n n a
جانور	dʒ a n uː r
جانچنا	dʒ a n tʃ n a
جانکاری	dʒ a n k a r iː
جاوید	dʒ a ʋ j d
جاوید	dʒ a ʋ j d
جاپان	dʒ a p a n
جاپانی	dʒ a p a n iː
جاگنا	dʒ a ɡ n a
جاگہ	dʒ a ɡ h
جب	dʒ b
جبرائیل	dʒ b r a ʔ iː l
جبرالٹر	dʒ b r a l ʈ r
جبوتی	dʒ b uː t iː
جبڑا	dʒ b ɽ a
جبیل	dʒ b iː l
جتوئی	dʒ t uː ʔ iː
جدا	dʒ d a
جدید	dʒ d iː d
جرأت	dʒ r t
جراثیم	dʒ r a s iː m
جراح	dʒ r a h
جراحت	dʒ r a h t
جرثومہ	dʒ r s uː m h
جرح	dʒ r h
جرسی	dʒ r s iː
جرم	dʒ r m
جرمانہ	dʒ r m a n h
جرمن	dʒ r m n
جرمنی	dʒ r m n iː
جرگہ	dʒ r ɡ h
جزیرہ	dʒ z iː r h
جستجو	dʒ s t dʒ uː
جستجو	dʒ s t dʒ uː
جسور	dʒ s uː r
جشن	dʒ ʃ n
جعلی	dʒ ʔ l iː
جغرافیائی	dʒ ɣ r a f iː a ʔ iː
جفتی	dʒ f t iː
جل	dʒ l
جلانا	dʒ l a n a
جلسہ	dʒ l s h
جلسہ	dʒ l s h
جلنا	dʒ l n a
جلوس	dʒ l uː s
جماعت	dʒ m a ʔ t
جماعت	dʒ m a ʔ t
جماگی	dʒ m a ɡ iː
جمعرات	dʒ m ʔ r a t
جمعرات	dʒ m ʔ r a t
جمعہ	dʒ m ʔ h
جموں	dʒ m uː ŋ
جمہوری	dʒ m h uː r iː
جمہوریت	dʒ m h uː r iː t
جمہوریہ	dʒ m h uː r iː h
جمہوریہ	dʒ m h uː r iː h
جن	dʒ n
جن	dʒ n
جناب	dʒ n a b
جنازو	dʒ n a z uː
جنازوں	dʒ n a z uː ŋ
جنازہ	dʒ n a z h
جنازے	dʒ n a z eː
جنت	dʒ n t
جنتا	dʒ n t a
جنتی	dʒ n t iː
جنرل	dʒ n r l
جنسی	dʒ n s iː
جنوبی	dʒ n uː b iː
جنوبی	dʒ n uː b iː
جنوری	dʒ n uː r iː
جنگ	dʒ n ɡ
جنگ	dʒ n ɡ
جنگل	dʒ n ɡ l
جنگلا	dʒ n ɡ l a
جنیئو	dʒ n iː ʔ uː
جوا	dʒ uː a
جوا	dʒ uː a
جوا	dʒ uː a
جواب	dʒ uː a b
جواب	dʒ uː a b
جواد	dʒ uː a d
جواز	dʒ uː a z
جوانی	dʒ uː a n iː
جوت	dʒ uː t
جوتا	dʒ uː t a
جور	dʒ uː r
جوز	dʒ uː z
جونپوری	dʒ uː n p uː r iː
جوڑ	dʒ uː ɽ
جوکھم	dʒ uː k ʰ m
جوگی	dʒ uː ɡ iː
جوں	dʒ uː ŋ
جوہر	dʒ uː h r
جوہری	dʒ uː h r iː
جوہی	dʒ uː h iː
جٹا	dʒ ʈ a
جپنا	dʒ p n a
جڑ	dʒ ɽ
جڑانوالہ	dʒ ɽ a n uː a l h
جڑواں	dʒ ɽ uː a ŋ
جڑواں	dʒ ɽ uː a ŋ
جگ	dʒ ɡ
جگاڑ	dʒ ɡ a ɽ
جگر	dʒ ɡ r
جگنا	dʒ ɡ n a
جگنو	dʒ ɡ n uː
جگہ	dʒ ɡ h
جگہ	dʒ ɡ h
جگہ	dʒ ɡ h
جگہ	dʒ ɡ h
جھارکھنڈ	dʒ ʰ a r k ʰ n ɖ
جھانجھ	dʒ ʰ a n dʒ ʰ
جھاڑنا	dʒ ʰ a ɽ n a
جھاڑو	dʒ ʰ a ɽ uː
جھلمل	dʒ ʰ l m l
جھنڈا	dʒ ʰ n ɖ a
جھنگ	dʒ ʰ n ɡ
جھولا	dʒ ʰ uː l a
جھوٹ	dʒ ʰ uː ʈ
جھوٹ	dʒ ʰ uː ʈ
جھوٹا	dʒ ʰ uː ʈ a
جھوٹھ	dʒ ʰ uː ʈ ʰ
جھیلمی	dʒ ʰ iː l m iː
جہاد	dʒ h a d
جہاز	dʒ h a z
جہازی	dʒ h a z iː
جہان	dʒ h a n
جہاں	dʒ h a ŋ
جہلم	dʒ h l m
جہنم	dʒ h n m
جہیز	dʒ h iː z
جی	dʒ iː
جیالا	dʒ iː a l a
جیالا	dʒ iː a l a
جیبھ	dʒ iː b ʰ
جیت	dʒ iː t
جیش	dʒ iː ʃ
جیل	dʒ iː l
جین	dʒ iː n
جیوتی	dʒ iː ʋ t iː
جیومیٹری	dʒ iː ʋ m iː ʈ r iː
جیون	dʒ iː ʋ n
جیونی	dʒ iː ʋ n iː
ح	h
حائل	h a ʔ l
حاجت	h a dʒ t
حادثہ	h a d s h
حاسب	h a s b
حاصل	h a s l
حاضری	h a z r iː
حافظ	h a f z
حال	h a l
حالانکہ	h a l a n k h
حالانکہ	h a l a n k h
حالت	h a l t
حامی	h a m iː
حب	h b
حبش	h b ʃ
حبشہ	h b ʃ h
حبشی	h b ʃ iː
حبقوق	h b q uː q
حج	h dʒ
حجام	h dʒ a m
حجرہ	h dʒ r h
حدیث	h d iː s
حراست	h r a s t
حرام	h r a m
حرمت	h r m t
حرمزئی	h r m z ʔ iː
حساب	h s a b
حسد	h s d
حسین	h s iː n
حسین	h s iː n
حسیں	h s iː ŋ
حشرہ	h ʃ r h
حشفہ	h ʃ f h
حصہ	h s h
حضرت	h z r t
حضور	h z uː r
حضور	h z uː r
حفاظت	h f a z t
حقوق	h q uː q
حقہ	h q h
حقیقت	h q iː q t
حلال	h l a l
حلب	h l b
حلقہ	h l q h
حلم	h l m
حلم	h l m
حلیہ	h l iː h
حلیہ	h l iː h
حلیہ	h l iː h
حمار	h m a r
حمارہ	h m a r h
حماقت	h m a q t
حماقت	h m a q t
حماقت	h m a q t
حمام	h m a m
حمایت	h m a j t
حمد	h m d
حملہ	h m l h
حنا	h n a
حنوکاہ	h n uː k a h
حواری	h uː a r iː
حور	h uː r
حوصلہ	h uː s l h
حوصلہ	h uː s l h
حوض	h uː z
حول	h uː l
حویلی	h uː j l iː
حکایت	h k a j t
حکم	h k m
حکومت	h k uː m t
حکیم	h k iː m
حیا	h iː a
حیات	h iː a t
حیاتیات	h iː a t iː a t
حیاتین	h iː a t iː n
حیران	h iː r a n
حیفا	h iː f a
حیفا	h iː f a
حیوان	h iː ʋ a n
حیوانیات	h iː ʋ a n iː a t
خ	x
خ	x
خاتمہ	x a t m h
خاتمہ	x a t m h
خاتون	x a t uː n
خادم	x a d m
خار	x a r
خاران	x a r a n
خارج	x a r dʒ
خارجہ	x a r dʒ h
خارجی	x a r dʒ iː
خارجی	x a r dʒ iː
خاص	x a s
خاصا	x a s a
خاصی	x a s iː
خاطر	x a t r
خاقانیت	x a q a n iː t
خال	x a l
خالق	x a l q
خالی	x a l iː
خاموش	x a m uː ʃ
خاموشی	x a m uː ʃ iː
خان	x a n
خاندان	x a n d a n
خانسامان	x a n s a m a n
خانساماں	x a n s a m a ŋ
خانوزئی	x a n uː z ʔ iː
خانپور	x a n p uː r
خانہ	x a n h
خانیت	x a n iː t
خانیوال	x a n iː ʋ a l
خاکسار	x a k s a r
خاکستری	x a k s t r iː
خاکی	x a k iː
خبر	x b r
ختم	x t m
ختم	x t m
خجیر	x dʒ iː r
خجیر	x dʒ iː r
خدا	x d a
خداوند	x d a ʋ n d
خدمت	x d m t
خدیو	x d iː ʋ
خدیو	x d iː ʋ
خدیو	x d iː ʋ
خراب	x r a b
خراش	x r a ʃ
خربوزہ	x r b uː z h
خرد	x r d
خرد	x r d
خرس	x r s
خرگوش	x r ɡ uː ʃ
خریدنا	x r iː d n a
خریدوانا	x r iː d uː a n a
خزاں	x z a ŋ
خزاں	x z a ŋ
خسارہ	x s a r h
خسرہ	x s r h
خشبو	x ʃ b uː
خشت	x ʃ t
خشم	x ʃ m
خصوصا	x s uː s a
خصوصا	x s uː s a
خصوصی	x s uː s iː
خضدار	x z d a r
خط	x t
خطبا	x t b a
خطبہ	x t b h
خطہ	x t h
خطیب	x t iː b
خطیب	x t iː b
خطیر	x t iː r
خطیہ	x t iː h
خفیہ	x f iː h
خفیہ	x f iː h
خلا	x l a
خلاف	x l a f
خلافت	x l a f t
خلفا	x l f a
خلق	x l q
خلقت	x l q t
خلقت	x l q t
خلل	x l l
خلیج	x l iː dʒ
خلیفہ	x l iː f h
خنجر	x n dʒ r
خواب	x uː a b
خواتین	x uː a t iː n
خواتین	x uː a t iː n
خواجہ	x uː a dʒ h
خواجہ	x uː a dʒ h
خواہ	x uː a h
خواہ	x uː a h
خواہر	x uː a h r
خواہش	x uː a h ʃ
خواہش	x uː a h ʃ
خوب	x uː b
خوبانی	x uː b a n iː
خوبصورت	x uː b s uː r t
خود	x uː d
خود	x uː d
خودمختاری	x uː d m x t a r iː
خودکش	x uː d k ʃ
خودکشی	x uː d k ʃ iː
خودکشی	x uː d k ʃ iː
خوراک	x uː r a k
خوش	x uː ʃ
خوشاب	x uː ʃ a b
خوشبو	x uː ʃ b uː
خوشبودار	x uː ʃ b uː d a r
خوشی	x uː ʃ iː
خوف	x uː f
خوفناک	x uː f n a k
خول	x uː l
خون	x uː n
خوک	x uː k
خوں	x uː ŋ
خيرپور	x r p uː r
خچر	x tʃ r
خیابان	x iː a b a n
خیال	x iː a l
خیال	x iː a l
خیال	x iː a l
خیر	x iː r
خیریت	x iː r iː t
خیلا	x iː l a
خیمہ	x iː m h
د	d
د	d
داؤد	d a ʔ d
داخل	d a x l
داخلہ	d a x l h
دادا	d a d a
دادو	d a d uː
دادی	d a d iː
دار	d a r
داردر	d a r d r
دارو	d a r uː
داریل	d a r iː l
داستان	d a s t a n
داستان	d a s t a n
داعش	d a ʔ ʃ
داغ	d a ɣ
داغستان	d a ɣ s t a n
دال	d a l
دالبندین	d a l b n d iː n
دام	d a m
دانت	d a n t
دانتی	d a n t iː
دانش	d a n ʃ
داڑم	d a ɽ m
دایاں	d a j a ŋ
دبئی	d b ʔ iː
دباؤ	d b a ʔ
دبستان	d b s t a n
دجلہ	d dʒ l h
دختر	d x t r
دخمہ	d x m h
دربار	d r b a r
درجات	d r dʒ a t
درجہ	d r dʒ h
درخت	d r x t
درخش	d r x ʃ
درخواست	d r x uː a s t
درد	d r d
دردو	d r d uː
دردوں	d r d uː ŋ
درزی	d r z iː
درست	d r s t
درفش	d r f ʃ
درفش	d r f ʃ
درفش	d r f ʃ
دروازہ	d r uː a z h
دروازہ	d r uː a z h
دروبست	d r uː b s t
درود	d r uː d
درگ	d r ɡ
درگاہ	d r ɡ a h
درہال	d r h a l
دری	d r iː
دریا	d r iː a
دریاچہ	d r iː a tʃ h
دریجی	d r iː dʒ iː
دزد	d z d
دس	d s
دستانو	d s t a n uː
دستانوں	d s t a n uː ŋ
دستانہ	d s t a n h
دستانے	d s t a n eː
دستاویز	d s t a ʋ j z
دستور	d s t uː r
دستک	d s t k
دستکاری	d s t k a r iː
دستہ	d s t h
دسمبر	d s m b r
دسواں	d s uː a ŋ
دشت	d ʃ t
دشمن	d ʃ m n
دشک	d ʃ k
دعا	d ʔ a
دعوت	d ʔ uː t
دعوت	d ʔ uː t
دعوی	d ʔ uː j
دعوی	d ʔ uː j
دفاع	d f a ʔ
دفتر	d f t r
دفعہ	d f ʔ h
دفنانا	d f n a n a
دقت	d q t
دقیقہ	d q iː q h
دل	d l
دلدادہ	d l d a d h
دلربا	d l r b a
دلو	d l uː
دلوں	d l uː ŋ
دلچسپ	d l tʃ s p
دلی	d l iː
دم	d m
دم	d m
دماغ	d m a ɣ
دمشق	d m ʃ q
دن	d n
دنداسہ	d n d a s h
دنوں	d n uː ŋ
دنڈ	d n ɖ
دنیا	d n iː a
دنیا	d n iː a
دنیاوی	d n iː a ʋ j
دنیور	d n iː ʋ r
دو	d uː
دوائی	d uː a ʔ iː
دوائی	d uː a ʔ iː
دوات	d uː a t
دوبارہ	d uː b a r h
دودمان	d uː d m a n
دودھ	d uː d ʰ
دور	d uː r
دور	d uː r
دوربین	d uː r b iː n
دوردرشن	d uː r d r ʃ n
دورلیکھ	d uː r l iː k ʰ
دوزخ	d uː z x
دوست	d uː s t
دوستانہ	d uː s t a n h
دوستی	d uː s t iː
دوسرا	d uː s r a
دوش	d uː ʃ
دوم	d uː m
دونا	d uː n a
دونمہ	d uː n m h
دوپہر	d uː p h r
دوڑنا	d uː ɽ n a
دوکی	d uː k iː
دوگنا	d uː ɡ n a
دژ	d ʒ
دژ	d ʒ
دژم	d ʒ m
دکھ	d k ʰ
دکھانا	d k ʰ a n a
دکھانا	d k ʰ a n a
دکھن	d k ʰ n
دگنا	d ɡ n a
دھات	d ʰ a t
دھادر	d ʰ a d r
دھارا	d ʰ a r a
دھارمک	d ʰ a r m k
دھاندل	d ʰ a n d l
دھاندلی	d ʰ a n d l iː
دھبا	d ʰ b a
دھرتی	d ʰ r t iː
دھرم	d ʰ r m
دھمال	d ʰ m a l
دھماکہ	d ʰ m a k h
دھن	d ʰ n
دھن	d ʰ n
دھندا	d ʰ n d a
دھندھا	d ʰ n d ʰ a
دھواں	d ʰ uː a ŋ
دھوج	d ʰ uː dʒ
دھوسر	d ʰ uː s r
دھول	d ʰ uː l
دھونا	d ʰ uː n a
دھونا	d ʰ uː n a
دھوپ	d ʰ uː p
دھڑکن	d ʰ ɽ k n
دھیریہ	d ʰ iː r iː h
دہ	d h
دہ	d h
دہ	d h
دہائی	d h a ʔ iː
دہان	d h a n
دہشت	d h ʃ t
دہقان	d h q a n
دہقان	d h q a n
دہقان	d h q a n
دہلوی	d h l uː j
دہلوی	d h l uː j
دہلی	d h l iː
دہلی	d h l iː
دہلی	d h l iː
دہی	d h iː
دہیز	d h iː z
دیا	d iː a
دیا	d iː a
دیاوان	d iː a ʋ a n
دیدار	d iː d a r
دیروز	d iː r uː z
دیز	d iː z
دیس	d iː s
دیسی	d iː s iː
دیش	d iː ʃ
دیشج	d iː ʃ dʒ
دینا	d iː n a
دینی	d iː n iː
دینے	d iː n eː
دیوانہ	d iː ʋ a n h
دیوبندی	d iː ʋ b n d iː
دیوناگری	d iː ʋ n a ɡ r iː
دیپ	d iː p
دیپک	d iː p k
دیپکا	d iː p k a
دیکھنا	d iː k ʰ n a
دیگچی	d iː ɡ tʃ iː
ذ	z
ذ	z
ذائقہ	z a ʔ q h
ذات	z a t
ذرہ	z r h
ذریعہ	z r iː ʔ h
ذلت	z l t
ذلیل	z l iː l
ذوق	z uː q
ذکر	z k r
ذکر	z k r
ذیابیطس	z iː a b iː t s
ر	r
ر	r
رؤسا	r ʔ s a
رئیس	r ʔ iː s
رائس	r a ʔ s
رائے	r a ʔ eː
رائے	r a ʔ eː
رابطہ	r a b t h
رات	r a t
راتا	r a t a
راج	r a dʒ
راجا	r a dʒ a
راجبھاشا	r a dʒ b ʰ a ʃ a
راجدھانی	r a dʒ d ʰ a n iː
راجستھان	r a dʒ s t ʰ a n
راجستھانی	r a dʒ s t ʰ a n iː
راجشاہی	r a dʒ ʃ a h iː
راجنیہ	r a dʒ n iː h
راجوری	r a dʒ uː r iː
راز	r a z
راستہ	r a s t h
راضی	r a z iː
رال	r a l
رامائن	r a m a ʔ n
ران	r a n
رانجھا	r a n dʒ ʰ a
رانی	r a n iː
راولپنڈی	r a ʋ l p n ɖ iː
راکٹ	r a k ʈ
راکھ	r a k ʰ
راکھس	r a k ʰ s
راکھشس	r a k ʰ ʃ s
راہ	r a h
راہب	r a h b
راہبہ	r a h b h
راہداری	r a h d a r iː
رب	r b
ربا	r b a
رباعی	r b a ʔ iː
ربوہ	r b uː h
رتبہ	r t b h
رتن	r t n
رجا	r dʒ a
رجل	r dʒ l
رخشان	r x ʃ a n
رخصتی	r x s t iː
رد	r d
رسالہ	r s a l h
رستم	r s t m
رسن	r s n
رسول	r s uː l
رسی	r s iː
رسید	r s iː d
رسیدو	r s iː d uː
رسیدوں	r s iː d uː ŋ
رسیدیں	r s iː d iː ŋ
رشتہ	r ʃ t h
رشوت	r ʃ uː t
رشی	r ʃ iː
رضا	r z a
رضیع	r z iː ʔ
رفتار	r f t a r
رفتن	r f t n
رفتن	r f t n
رفع	r f ʔ
رفقا	r f q a
رقص	r q s
رمزی	r m z iː
رمضان	r m z a n
رمضان	r m z a n
رمہ	r m h
رنڈی	r n ɖ iː
رنگ	r n ɡ
رنگت	r n ɡ t
رنگولی	r n ɡ uː l iː
رنگپور	r n ɡ p uː r
روان	r uː a n
روانڈا	r uː a n ɖ a
روانگی	r uː a n ɡ iː
روانہ	r uː a n h
روایت	r uː a j t
روح	r uː h
روحانی	r uː h a n iː
روز	r uː z
روزن	r uː z n
روزنامہ	r uː z n a m h
روزہ	r uː z h
روس	r uː s
روشن	r uː ʃ n
روشن	r uː ʃ n
روشنی	r uː ʃ n iː
روشنی	r uː ʃ n iː
روغن	r uː ɣ n
روغن	r uː ɣ n
رومال	r uː m a l
رومانیہ	r uː m a n iː h
رومی	r uː m iː
رونا	r uː n a
روٹی	r uː ʈ iː
روپ	r uː p
روپیہ	r uː p iː h
روپیہ	r uː p iː h
روچڈیل	r uː tʃ ɖ iː l
روچڈیل	r uː tʃ ɖ iː l
روچڈیل	r uː tʃ ɖ iː l
روی	r uː j
رویئہ	r uː j ʔ h
رویہ	r uː j h
رڑک	r ɽ k
رکاوٹ	r k a ʋ ʈ
رکت	r k t
رکشا	r k ʃ a
رکعت	r k ʔ t
رگوید	r ɡ uː j d
رگوید	r ɡ uː j d
رہائش	r h a ʔ ʃ
رہائش	r h a ʔ ʃ
رہبر	r h b r
رہنا	r h n a
ریاست	r iː a s t
ریاستہا	r iː a s t h a
ریاض	r iː a z
ریاضی	r iː a z iː
ریب	r iː b
ریت	r iː t
ریختہ	r iː x t h
ریش	r iː ʃ
ریش	r iː ʃ
ریشم	r iː ʃ m
ریشہ	r iː ʃ h
ریشہ	r iː ʃ h
ریپھ	r iː p ʰ
ریچھ	r iː tʃ ʰ
ریڈیو	r iː ɖ iː ʋ
ریکھا	r iː k ʰ a
ز	z
ز	z
زائر	z a ʔ r
زار	z a r
زایندہ	z a j n d h
زایندہ	z a j n d h
زبان	z b a n
زبان	z b a n
زبردستی	z b r d s t iː
زخم	z x m
زرافہ	z r a f h
زرتشت	z r t ʃ t
زردوزی	z r d uː z iː
زرشک	z r ʃ k
زعفران	z ʔ f r a n
زمانہ	z m a n h
زمین	z m iː n
زن	z n
زنجیر	z n dʒ iː r
زندگی	z n d ɡ iː
زندہ	z n d h
زنگ	z n ɡ
زنگبار	z n ɡ b a r
زنگی	z n ɡ iː
زور	z uː r
زور	z uː r
زوردار	z uː r d a r
زون	z uː n
زيربند	z r b n d
زکات	z k a t
زکریا	z k r iː a
زکوۃ	z k uː
زہری	z h r iː
زہیب	z h iː b
زیادتی	z iː a d t iː
زیادتی	z iː a d t iː
زیارت	z iː a r t
زیتون	z iː t uː n
زیور	z iː ʋ r
س	s
س	s
سؤر	s ʔ r
سؤر	s ʔ r
سا	s a
سائز	s a ʔ z
سائنس	s a ʔ n s
سائنس	s a ʔ n s
سائنسدان	s a ʔ n s d a n
سائنسی	s a ʔ n s iː
سائنسی	s a ʔ n s iː
سائیکل	s a ʔ iː k l
سات	s a t
ساتواں	s a t uː a ŋ
ساتھ	s a t ʰ
ساتھی	s a t ʰ iː
ساحل	s a h l
ساحلی	s a h l iː
سارا	s a r a
سازش	s a z ʃ
سال	s a l
سالانہ	s a l a n h
سالگرہ	s a l ɡ r h
سامراجیہ	s a m r a dʒ iː h
سامعین	s a m ʔ iː n
سامی	s a m iː
سامیہ	s a m iː h
سانبہ	s a n b h
سانس	s a n s
سانولا	s a n uː l a
سانپ	s a n p
ساودھان	s a ʋ d ʰ a n
ساڑی	s a ɽ iː
ساکشیہ	s a k ʃ iː h
ساگر	s a ɡ r
ساہتیہ	s a h t iː h
ساہیوال	s a h iː ʋ a l
سب	s b
سبد	s b d
سبز	s b z
سبزی	s b z iː
سبھا	s b ʰ a
سبی	s b iː
ستارہ	s t a r h
ستارے	s t a r eː
ستم	s t m
ستون	s t uː n
سجدہ	s dʒ d h
سحری	s h r iː
سخی	s x iː
سدابہار	s d a b h a r
سدن	s d n
سدھارنا	s d ʰ a r n a
سدھارک	s d ʰ a r k
سرائیکی	s r a ʔ iː k iː
سراب	s r a b
سرانان	s r a n a n
سرحد	s r h d
سرخ	s r x
سرخی	s r x iː
سردیاں	s r d iː a ŋ
سرزمین	s r z m iː n
سرسائی	s r s a ʔ iː
سرسوتی	s r s uː t iː
سرسوتی	s r s uː t iː
سرسوں	s r s uː ŋ
سرشت	s r ʃ t
سرشپ	s r ʃ p
سرفروش	s r f r uː ʃ
سرما	s r m a
سرما	s r m a
سرمایہ	s r m a j h
سرمہ	s r m h
سرور	s r uː r
سرورق	s r uː r q
سروش	s r uː ʃ
سرونام	s r uː n a m
سرکار	s r k a r
سرکس	s r k s
سرگ	s r ɡ
سرگرم	s r ɡ r m
سرگرمی	s r ɡ r m iː
سرگودھا	s r ɡ uː d ʰ a
سرہانہ	s r h a n h
سریانی	s r iː a n iː
سریر	s r iː r
سریع	s r iː ʔ
سزا	s z a
سسا	s s a
سسا	s s a
سست	s s t
سستا	s s t a
سستی	s s t iː
سستی	s s t iː
سسر	s s r
سسر	s s r
سطح	s t h
سغدی	s ɣ d iː
سفارت	s f a r t
سفارش	s f a r ʃ
سفال	s f a l
سفر	s f r
سفید	s f iː d
سفیر	s f iː r
سلاح	s l a h
سلام	s l a m
سلامت	s l a m t
سلامتی	s l a m t iː
سلجوق	s l dʒ uː q
سلجوقی	s l dʒ uː q iː
سلسلہ	s l s l h
سلطان	s l t a n
سلطنت	s l t n t
سلوواکیہ	s l uː ʋ a k iː h
سلوک	s l uː k
سلوک	s l uː k
سلہٹ	s l h ʈ
سلیمان	s l iː m a n
سمئے	s m ʔ eː
سماج	s m a dʒ
سمادھان	s m a d ʰ a n
سماس	s m a s
سماعت	s m a ʔ t
سماپت	s m a p t
سماپن	s m a p n
سماچار	s m a tʃ a r
سمبڑیال	s m b ɽ iː a l
سمجھ	s m dʒ ʰ
سمجھدار	s m dʒ ʰ d a r
سمجھنا	s m dʒ ʰ n a
سمجھوتہ	s m dʒ ʰ uː t h
سمدائے	s m d a ʔ eː
سمدر	s m d r
سمراٹ	s m r a ʈ
سمرتی	s m r t iː
سمرتی	s m r t iː
سمرتی	s m r t iː
سمرقند	s m r q n d
سمسم	s m s m
سمع	s m ʔ
سمندر	s m n d r
سمندر	s m n d r
سمندری	s m n d r iː
سموسہ	s m uː s h
سموہ	s m uː h
سمپردائے	s m p r d a ʔ eː
سمپردائے	s m p r d a ʔ eː
سمکالین	s m k a l iː n
سمکھ	s m k ʰ
سمین	s m iː n
سن	s n
سناتن	s n a t n
سنانا	s n a n a
سناٹا	s n a ʈ a
سنت	s n t
سنت	s n t
سنتان	s n t a n
سنترا	s n t r a
سنترا	s n t r a
سنجھا	s n dʒ ʰ a
سندر	s n d r
سندھ	s n d ʰ
سندھی	s n d ʰ iː
سندیش	s n d iː ʃ
سندیہ	s n d iː h
سنسار	s n s a r
سنسکرت	s n s k r t
سنشیہ	s n ʃ iː h
سننا	s n n a
سنگ	s n ɡ
سنگاپور	s n ɡ a p uː r
سنگم	s n ɡ m
سنگھ	s n ɡ ʰ
سنگھرش	s n ɡ ʰ r ʃ
سنگیت	s n ɡ iː t
سنہ	s n h
سنیوگ	s n iː ʋ ɡ
سنیچر	s n iː tʃ r
سوئی	s uː ʔ iː
سوادو	s uː a d uː
سوال	s uː a l
سوال	s uː a l
سوالات	s uː a l a t
سوالو	s uː a l uː
سوالوں	s uː a l uː ŋ
سوانگ	s uː a n ɡ
سواگت	s uː a ɡ t
سوتا	s uː t a
سوتیلا	s uː t iː l a
سوتے	s uː t eː
سودا	s uː d a
سوراب	s uː r a b
سورج	s uː r dʒ
سورہ	s uː r h
سوری	s uː r iː
سوریہ	s uː r iː h
سوریہ	s uː r iː h
سوستک	s uː s t k
سوغات	s uː ɣ a t
سوم	s uː m
سونا	s uː n a
سونا	s uː n a
سويمور	s uː m uː r
سوپن	s uː p n
سوچنا	s uː tʃ n a
سوڈان	s uː ɖ a n
سوکھا	s uː k ʰ a
سویٹزرلینڈ	s uː j ʈ z r l iː n ɖ
سویڈن	s uː j ɖ n
سپارہ	s p a r h
سپاس	s p a s
سپاس	s p a s
سپاہ	s p a h
سپاہنی	s p a h n iː
سپاہی	s p a h iː
سپتاہ	s p t a h
سپنا	s p n a
سچ	s tʃ
سڑک	s ɽ k
سکا	s k a
سکنا	s k n a
سکندر	s k n d r
سکھ	s k ʰ
سکھر	s k ʰ r
سکہ	s k h
سگ	s ɡ
سگریٹ	s ɡ r iː ʈ
سہایک	s h a j k
سہج	s h dʒ
سہس	s h s
سہمانا	s h m a n a
سہمت	s h m t
سہمنا	s h m n a
سہواس	s h uː a s
سہولت	s h uː l t
سہولت	s h uː l t
سہیلی	s h iː l iː
سیاحت	s iː a h t
سیارہ	s iː a r h
سیاست	s iː a s t
سیاستدان	s iː a s t d a n
سیاسی	s iː a s iː
سیالکوٹ	s iː a l k uː ʈ
سیب	s iː b
سیخ	s iː x
سیر	s iː r
سیلاب	s iː l a b
سینکڑا	s iː n k ɽ a
سینکڑا	s iː n k ɽ a
سینگ	s iː n ɡ
سینیٹر	s iː n iː ʈ r
سیٹھا	s iː ʈ ʰ a
سیڑھی	s iː ɽ ʰ iː
سیکھنا	s iː k ʰ n a
سے	s eː
ش	ʃ
ش	ʃ
شاباش	ʃ a b a ʃ
شاخ	ʃ a x
شاد	ʃ a d
شادی	ʃ a d iː
شارجہ	ʃ a r dʒ h
شاستر	ʃ a s t r
شاسن	ʃ a s n
شاسک	ʃ a s k
شاعر	ʃ a ʔ r
شاعرہ	ʃ a ʔ r h
شاعری	ʃ a ʔ r iː
شام	ʃ a m
شامل	ʃ a m l
شان	ʃ a n
شانتی	ʃ a n t iː
شاور	ʃ a ʋ r
شاپر	ʃ a p r
شاگرد	ʃ a ɡ r d
شاہراہ	ʃ a h r a h
شاہی	ʃ a h iː
شاہین	ʃ a h iː n
شاید	ʃ a j d
شب	ʃ b
شبد	ʃ b d
شبدکوش	ʃ b d k uː ʃ
شبنم	ʃ b n m
شبھ	ʃ b ʰ
شتابدی	ʃ t a b d iː
شترو	ʃ t r uː
شتک	ʃ t k
شجر	ʃ dʒ r
شخص	ʃ x s
شدت	ʃ d t
شراب	ʃ r a b
شرارتی	ʃ r a r t iː
شرارتی	ʃ r a r t iː
شرط	ʃ r t
شرطی	ʃ r t iː
شرفا	ʃ r f a
شرم	ʃ r m
شرمگیں	ʃ r m ɡ iː ŋ
شرک	ʃ r k
شرکرا	ʃ r k r a
شریر	ʃ r iː r
شریعت	ʃ r iː ʔ t
شرینگر	ʃ r iː n ɡ r
ششن	ʃ ʃ n
ششک	ʃ ʃ k
شعر	ʃ ʔ r
شعرا	ʃ ʔ r a
شعلوں	ʃ ʔ l uː ŋ
شعلہ	ʃ ʔ l h
شعلے	ʃ ʔ l eː
شعیب	ʃ ʔ iː b
شفا	ʃ f a
شفقت	ʃ f q t
شفیق	ʃ f iː q
شقرا	ʃ q r a
شلیہ	ʃ l iː h
شمال	ʃ m a l
شمال	ʃ m a l
شمشیر	ʃ m ʃ iː r
شمشیر	ʃ m ʃ iː r
شناخت	ʃ n a x t
شنتانو	ʃ n t a n uː
شوربا	ʃ uː r b a
شوق	ʃ uː q
شوپیاں	ʃ uː p iː a ŋ
شوہر	ʃ uː h r
شيخوپورہ	ʃ x uː p uː r h
شکار	ʃ k a r
شکارپور	ʃ k a r p uː r
شکایت	ʃ k a j t
شکتی	ʃ k t iː
شکر	ʃ k r
شکر	ʃ k r
شکر	ʃ k r
شکریہ	ʃ k r iː h
شگن	ʃ ɡ n
شہادت	ʃ h a d t
شہباز	ʃ h b a z
شہتوت	ʃ h t uː t
شہدا	ʃ h d a
شہر	ʃ h r
شہروز	ʃ h r uː z
شہری	ʃ h r iː
شہزادہ	ʃ h z a d h
شہلا	ʃ h l a
شہنشاہ	ʃ h n ʃ a h
شہنشاہ	ʃ h n ʃ a h
شہید	ʃ h iː d
شہیدو	ʃ h iː d uː
شہیدوں	ʃ h iː d uː ŋ
شیخ	ʃ iː x
شیدا	ʃ iː d a
شیدا	ʃ iː d a
شیر	ʃ iː r
شیر	ʃ iː r
شیشہ	ʃ iː ʃ h
شیطان	ʃ iː t a n
شیفیلڈ	ʃ iː f iː l ɖ
شیو	ʃ iː ʋ
شیو	ʃ iː ʋ
شیکھاواٹی	ʃ iː k ʰ a ʋ a ʈ iː
شے	ʃ eː
ص	s
ص	s
صائب	s a ʔ b
صابر	s a b r
صابن	s a b n
صاحب	s a h b
صاحب	s a h b
صاحب	s a h b
صارف	s a r f
صارفین	s a r f iː n
صاف	s a f
صالح	s a l h
صبح	s b h
صبح	s b h
صبح	s b h
صبر	s b r
صبر	s b r
صحافی	s h a f iː
صحافی	s h a f iː
صحت	s h t
صحت	s h t
صحن	s h n
صحیح	s h iː h
صحیح	s h iː h
صدا	s d a
صدقہ	s d q h
صعب	s ʔ b
صعب	s ʔ b
صغیر	s ɣ iː r
صفائی	s f a ʔ iː
صفائی	s f a ʔ iː
صفحہ	s f h h
صفحہ	s f h h
صفرواں	s f r uː a ŋ
صلاح	s l a h
صلاحیت	s l a h iː t
صلوۃ	s l uː
صلہ	s l h
صلی	s l iː
صلیب	s l iː b
صلیبی	s l iː b iː
صنعت	s n ʔ t
صنم	s n m
صوابی	s uː a b iː
صوبہ	s uː b h
صورت	s uː r t
ض	z
ض	z
ضابطہ	z a b t h
ضبط	z b t
ضد	z d
ضدی	z d iː
ضرر	z r r
ضرور	z r uː r
ضرورت	z r uː r t
ضروری	z r uː r iː
ضروری	z r uː r iː
ضلع	z l ʔ
ضم	z m
ضمانت	z m a n t
ضیافت	z iː a f t
ط	t
ط	t
طاعون	t a ʔ uː n
طاقت	t a q t
طاقتور	t a q t uː r
طالبان	t a l b a n
طبق	t b q
طبلہ	t b l h
طبی	t b iː
طبیب	t b iː b
طبیعت	t b iː ʔ t
طبیعی	t b iː ʔ iː
طبیعیات	t b iː ʔ iː a t
طرابلس	t r a b l s
طرح	t r h
طرح	t r h
طرح	t r h
طرف	t r f
طریقہ	t r iː q h
طشتری	t ʃ t r iː
طعام	t ʔ a m
طفل	t f l
طلاق	t l a q
طلعت	t l ʔ t
طلوع	t l uː ʔ
طوائف	t uː a ʔ f
طوبی	t uː b iː
طور	t uː r
طور	t uː r
طوفان	t uː f a n
طیارہ	t iː a r h
طیب	t iː b
طیب	t iː b
طیر	t iː r
ظ	z
ظ	z
ظالم	z a l m
ظرف	z r f
ظفر	z f r
ظلم	z l m
ع	ʔ
ع	ʔ
ع	ʔ
ع	ʔ
ع	ʔ
عائلہ	ʔ a ʔ l h
عائلی	ʔ a ʔ l iː
عابد	ʔ a b d
عابدہ	ʔ a b d h
عادت	ʔ a d t
عاشق	ʔ a ʃ q
عاصی	ʔ a s iː
عالم	ʔ a l m
عالم	ʔ a l m
عالیہ	ʔ a l iː h
عام	ʔ a m
عاملہ	ʔ a m l h
عبادت	ʔ b a d t
عبادتی	ʔ b a d t iː
عبرانی	ʔ b r a n iː
عبری	ʔ b r iː
عجائب	ʔ dʒ a ʔ b
عجائب	ʔ dʒ a ʔ b
عجائبات	ʔ dʒ a ʔ b a t
عجمی	ʔ dʒ m iː
عجوبہ	ʔ dʒ uː b h
عجیب	ʔ dʒ iː b
عدالت	ʔ d a l t
عدس	ʔ d s
عدم	ʔ d m
عراق	ʔ r a q
عربستان	ʔ r b s t a n
عربی	ʔ r b iː
عرش	ʔ r ʃ
عرشی	ʔ r ʃ iː
عرض	ʔ r z
عرضی	ʔ r z iː
عرق	ʔ r q
عزیز	ʔ z iː z
عشائیہ	ʔ ʃ a ʔ iː h
عشق	ʔ ʃ q
عضو	ʔ z uː
عطر	ʔ t r
عظم	ʔ z m
عظیم	ʔ z iː m
عظیم	ʔ z iː m
عفو	ʔ f uː
عفو	ʔ f uː
عقل	ʔ q l
عقیلہ	ʔ q iː l h
علاج	ʔ l a dʒ
علاقہ	ʔ l a q h
علم	ʔ l m
علم	ʔ l m
علما	ʔ l m a
علمی	ʔ l m iː
علمیات	ʔ l m iː a t
علوم	ʔ l uː m
علی	ʔ l iː
علی	ʔ l iː
علی	ʔ l iː
علیحدگی	ʔ l iː h d ɡ iː
علیحدہ	ʔ l iː h d h
علینہ	ʔ l iː n h
عمان	ʔ m a n
عمان	ʔ m a n
عمدہ	ʔ m d h
عمر	ʔ m r
عمر	ʔ m r
عمران	ʔ m r a n
عمرکوٹ	ʔ m r k uː ʈ
عمل	ʔ m l
عملہ	ʔ m l h
عموما	ʔ m uː m a
عموما	ʔ m uː m a
عمومی	ʔ m uː m iː
عنب	ʔ n b
عنصر	ʔ n s r
عنصر	ʔ n s r
عنوان	ʔ n uː a n
عنوان	ʔ n uː a n
عوام	ʔ uː a m
عورت	ʔ uː r t
عورت	ʔ uː r t
عورتو	ʔ uː r t uː
عورتو	ʔ uː r t uː
عورتوں	ʔ uː r t uː ŋ
عورتوں	ʔ uː r t uː ŋ
عورتیں	ʔ uː r t iː ŋ
عورتیں	ʔ uː r t iː ŋ
عکرشہ	ʔ k r ʃ h
عکس	ʔ k s
عہد	ʔ h d
عہدہ	ʔ h d h
عیادت	ʔ iː a d t
عیادت	ʔ iː a d t
عیاشی	ʔ iː a ʃ iː
عیاشی	ʔ iː a ʃ iː
عیاں	ʔ iː a ŋ
عید	ʔ iː d
عیسائی	ʔ iː s a ʔ iː
عیسائیت	ʔ iː s a ʔ iː t
عیسی	ʔ iː s iː
عیش	ʔ iː ʃ
عین	ʔ iː n
عینک	ʔ iː n k
غ	ɣ
غ	ɣ
غائب	ɣ a ʔ b
غار	ɣ a r
غالبا	ɣ a l b a
غالی	ɣ a l iː
غدار	ɣ d a r
غذا	ɣ z a
غرض	ɣ r z
غرناطہ	ɣ r n a t h
غروب	ɣ r uː b
غرور	ɣ r uː r
غریب	ɣ r iː b
غزل	ɣ z l
غزوہ	ɣ z uː h
غزہ	ɣ z h
غسل	ɣ s l
غسلخانہ	ɣ s l x a n h
غش	ɣ ʃ
غضب	ɣ z b
غفلت	ɣ f l t
غلام	ɣ l a m
غلطی	ɣ l t iː
غلہ	ɣ l h
غم	ɣ m
غمر	ɣ m r
غنائیت	ɣ n a ʔ iː t
غنچہ	ɣ n tʃ h
غنڈہ	ɣ n ɖ h
غنہ	ɣ n h
غور	ɣ uː r
غوٹہ	ɣ uː ʈ h
غژماں	ɣ ʒ m a ŋ
غیر	ɣ iː r
غیرت	ɣ iː r t
ف	f
ف	f
فادر	f a d r
فارسی	f a r s iː
فارغ	f a r ɣ
فاس	f a s
فاسد	f a s d
فاصلہ	f a s l h
فاصلہ	f a s l h
فاضل	f a z l
فاقہ	f a q h
فالتو	f a l t uː
فالج	f a l dʒ
فالحال	f a l h a l
فالسئی	f a l s ʔ iː
فالسہ	f a l s h
فالودہ	f a l uː d h
فانوس	f a n uː s
فانی	f a n iː
فاکہہ	f a k h h
فتنہ	f t n h
فجی	f dʒ iː
فحش	f h ʃ
فخر	f x r
فدیہ	f d iː h
فرات	f r a t
فرات	f r a t
فراز	f r a z
فراموش	f r a m uː ʃ
فرانس	f r a n s
فرانس	f r a n s
فرانس	f r a n s
فرانسیسی	f r a n s iː s iː
فراہم	f r a h m
فربہ	f r b h
فرزند	f r z n d
فرش	f r ʃ
فرشتہ	f r ʃ t h
فرشتہ	f r ʃ t h
فرص	f r s
فرصت	f r s t
فرض	f r z
فرض	f r z
فرضی	f r z iː
فرعون	f r ʔ uː n
فرقہ	f r q h
فرمائش	f r m a ʔ ʃ
فرمان	f r m a n
فرمانا	f r m a n a
فرنگی	f r n ɡ iː
فرہنگ	f r h n ɡ
فریاد	f r iː a d
فریال	f r iː a l
فرینکفرٹ	f r iː n k f r ʈ
فزان	f z a n
فساد	f s a d
فسادی	f s a d iː
فسانہ	f s a n h
فضا	f z a
فضائیہ	f z a ʔ iː h
فطرت	f t r t
فقہ	f q h
فقیر	f q iː r
فلاں	f l a ŋ
فلسطین	f l s t iː n
فلپائن	f l p a ʔ n
فلپائن	f l p a ʔ n
فلک	f l k
فلکیات	f l k iː a t
فن	f n
فوتگی	f uː t ɡ iː
فوتگی	f uː t ɡ iː
فوج	f uː dʒ
فورا	f uː r a
فون	f uː n
فون	f uː n
فٹافٹ	f ʈ a f ʈ
فٹافٹ	f ʈ a f ʈ
فکر	f k r
فیروزوالہ	f iː r uː z uː a l h
فیروزہ	f iː r uː z h
فیروزی	f iː r uː z iː
فیصد	f iː s d
فیصل	f iː s l
فیصلہ	f iː s l h
فیل	f iː l
ق	q
ق	q
قاب	q a b
قابض	q a b z
قابل	q a b l
قابلیت	q a b l iː t
قاتل	q a t l
قاتل	q a t l
قادیان	q a d iː a n
قاری	q a r iː
قاضی	q a z iː
قاعدہ	q a ʔ d h
قافلہ	q a f l h
قافلہ	q a f l h
قافیہ	q a f iː h
قاقم	q a q m
قالین	q a l iː n
قاموس	q a m uː s
قانون	q a n uː n
قانونی	q a n uː n iː
قاچاقی	q a tʃ a q iː
قاہرہ	q a h r h
قبر	q b r
قبرستان	q b r s t a n
قبرص	q b r s
قبض	q b z
قبضہ	q b z h
قبل	q b l
قبلتین	q b l t iː n
قبول	q b uː l
قتل	q t l
قدم	q d m
قدم	q d m
قدیم	q d iː m
قرآن	q r ɑː n
قرار	q r a r
قراقرم	q r a q r m
قربانی	q r b a n iː
قرض	q r z
قرضہ	q r z h
قرطبہ	q r t b h
قرمزی	q r m z iː
قرہ	q r h
قریب	q r iː b
قزاقستان	q z a q s t a n
قسط	q s t
قسم	q s m
قسم	q s m
قسمت	q s m t
قشنگ	q ʃ n ɡ
قصائی	q s a ʔ iː
قصاب	q s a b
قصاص	q s a s
قصبات	q s b a t
قصبوں	q s b uː ŋ
قصبہ	q s b h
قصبے	q s b eː
قصور	q s uː r
قصہ	q s h
قطار	q t a r
قطب	q t b
قطب	q t b
قطعی	q t ʔ iː
ققنس	q q n s
قلات	q l a t
قلب	q l b
قلعہ	q l ʔ h
قلعہ	q l ʔ h
قلعہ	q l ʔ h
قلم	q l m
قلندر	q l n d r
قلی	q l iː
قمچی	q m tʃ iː
قمیص	q m iː s
قمیض	q m iː z
قواعد	q uː a ʔ d
قوت	q uː t
قوت	q uː t
قوطی	q uː t iː
قوق	q uː q
قوم	q uː m
قومی	q uː m iː
قومیت	q uː m iː t
قوی	q uː j
قوی	q uː j
قہر	q h r
قہقہہ	q h q h h
قہوہ	q h uː h
قیادت	q iː a d t
قیامت	q iː a m t
قید	q iː d
قیمت	q iː m t
قیمتی	q iː m t iː
قیمہ	q iː m h
قینچی	q iː n tʃ iː
قے	q eː
كشی	k ʃ iː
ل	l
ل	l
لائبریری	l a ʔ b r iː r iː
لائٹر	l a ʔ ʈ r
لاجورد	l a dʒ uː r d
لاجوردی	l a dʒ uː r d iː
لازم	l a z m
لال	l a l
لالٹین	l a l ʈ iː n
لالہ	l a l h
لامتناہی	l a m t n a h iː
لانڈگا	l a n ɖ ɡ a
لاوارث	l a ʋ a r s
لاٹھی	l a ʈ ʰ iː
لاپتہ	l a p t h
لاپروا	l a p r uː a
لاڈلہ	l a ɖ l h
لاڑکانہ	l a ɽ k a n h
لاکھ	l a k ʰ
لاہور	l a h uː r
لاہور	l a h uː r
لاہوری	l a h uː r iː
لب	l b
لباس	l b a s
لبنان	l b n a n
لبنان	l b n a n
لبھانا	l b ʰ a n a
لتھوینیا	l t ʰ uː j n iː a
لجنہ	l dʒ n h
لجنہ	l dʒ n h
لداخ	l d a x
لدھیانہ	l d ʰ iː a n h
لرزاں	l r z a ŋ
لسان	l s a n
لسانیات	l s a n iː a t
لطفا	l t f a
لطیفہ	l t iː f h
لعب	l ʔ b
لغت	l ɣ t
لغو	l ɣ uː
لغوی	l ɣ uː j
لفافہ	l f a f h
لفظ	l f z
لفظ	l f z
لفظ	l f z
لفنگا	l f n ɡ a
لقب	l q b
لقمان	l q m a n
للاٹ	l l a ʈ
لمبا	l m b a
لمبائی	l m b a ʔ iː
لمحاتی	l m h a t iː
لمپٹ	l m p ʈ
لندن	l n d n
لنگ	l n ɡ
لنگایت	l n ɡ a j t
لوبیا	l uː b iː a
لوتھ	l uː t ʰ
لودهراں	l uː d r a ŋ
لورالائی	l uː r a l a ʔ iː
لوری	l uː r iː
لوسیل	l uː s iː l
لوط	l uː t
لوٹا	l uː ʈ a
لوٹا	l uː ʈ a
لوٹا	l uː ʈ a
لوگ	l uː ɡ
لوگو	l uː ɡ uː
لوگوں	l uː ɡ uː ŋ
لوہا	l uː h a
لوہار	l uː h a r
لڑائی	l ɽ a ʔ iː
لڑنا	l ɽ n a
لڑکا	l ɽ k a
لڑکی	l ɽ k iː
لکشادیپ	l k ʃ a d iː p
لکشمی	l k ʃ m iː
لکڑی	l k ɽ iː
لکھائی	l k ʰ a ʔ iː
لکھنا	l k ʰ n a
لگام	l ɡ a m
لگانا	l ɡ a n a
لگے	l ɡ eː
لہجہ	l h dʒ h
لہذا	l h z a
لہرانا	l h r a n a
لہسن	l h s n
لہنگا	l h n ɡ a
لہنگا	l h n ɡ a
لہو	l h uː
لیئج	l iː ʔ dʒ
لیئج	l iː ʔ dʒ
لیسٹر	l iː s ʈ r
لیل	l iː l
لیموں	l iː m uː ŋ
لیموں	l iː m uː ŋ
لینا	l iː n a
لیون	l iː ʋ n
لیون	l iː ʋ n
لیوں	l iː ʋ ŋ
لیوں	l iː ʋ ŋ
لیٹنا	l iː ʈ n a
لیکن	l iː k n
لیکھ	l iː k ʰ
لیکھنی	l iː k ʰ n iː
لیکھک	l iː k ʰ k
لیہہ	l iː h h
م	m
م	m
مؤذن	m ʔ z n
مؤسسہ	m ʔ s s h
ماء	m a ʔ
ماتا	m a t a
ماتم	m a t m
ماتھا	m a t ʰ a
ماحول	m a h uː l
مارنا	m a r n a
مارونی	m a r uː n iː
مارگ	m a r ɡ
ماسکو	m a s k uː
ماضی	m a z iː
مالا	m a l a
مالدیپ	m a l d iː p
مالٹا	m a l ʈ a
مالک	m a l k
ماما	m a m a
ماموں	m a m uː ŋ
ماندہ	m a n d h
ماندہ	m a n d h
مانسہرہ	m a n s h r h
مانوس	m a n uː s
مانچسٹر	m a n tʃ s ʈ r
مانگ	m a n ɡ
ماہ	m a h
ماہانہ	m a h a n h
ماہر	m a h r
ماہرین	m a h r iː n
ماہی	m a h iː
ماہ‌جبیں	m a h dʒ b iː ŋ
مبارک	m b a r k
مبارک	m b a r k
مبلغ	m b l ɣ
مبلغ	m b l ɣ
مبلغ	m b l ɣ
مبنی	m b n iː
مت	m t
متجسس	m t dʒ s s
مترا	m t r a
مترائی	m t r a ʔ iː
مترجم	m t r dʒ m
متسیہ	m t s iː h
متعارف	m t ʔ a r f
متعلق	m t ʔ l q
متلی	m t l iː
متوالی	m t uː a l iː
متوجہ	m t uː dʒ h
متولد	m t uː l d
متولی	m t uː l iː
متھرا	m t ʰ r a
مثال	m s a l
مثلا	m s l a
مجبور	m dʒ b uː r
مجرم	m dʒ r m
مجھ	m dʒ ʰ
مجھے	m dʒ ʰ eː
مجھے	m dʒ ʰ eː
مجہول	m dʒ h uː l
محاسب	m h a s b
محافظ	m h a f z
محافظت	m h a f z t
محبت	m h b t
محبت	m h b t
محتسب	m h t s b
محراب	m h r a b
محراب	m h r a b
محروم	m h r uː m
محسوس	m h s uː s
محشر	m h ʃ r
محفل	m h f l
محل	m h l
محل	m h l
محلہ	m h l h
محلہ	m h l h
محلہ	m h l h
محمد	m h m d
محمد	m h m d
محمدی	m h m d iː
محنت	m h n t
محنت	m h n t
مختصر	m x t s r
مختصرا	m x t s r a
مختلف	m x t l f
مختلف	m x t l f
مخدوم	m x d uː m
مخزن	m x z n
مخلوط	m x l uː t
مخمل	m x m l
مخملی	m x m l iː
مدت	m d t
مدد	m d d
مددگار	m d d ɡ a r
مدرا	m d r a
مدعی	m d ʔ iː
مدعی	m d ʔ iː
مدھم	m d ʰ m
مدیر	m d iː r
مدیرا	m d iː r a
مدینہ	m d iː n h
مذاق	m z a q
مذمت	m z m t
مذکر	m z k r
مذہب	m z h b
مذہبی	m z h b iː
مراٹھی	m r a ʈ ʰ iː
مراکش	m r a k ʃ
مربا	m r b a
مربع	m r b ʔ
مرتبہ	m r t b h
مرتیو	m r t iː ʋ
مرد	m r d
مردار	m r d a r
مردان	m r d a n
مردانگی	m r d a n ɡ iː
مردانہ	m r d a n h
مردنی	m r d n iː
مردنی	m r d n iː
مرض	m r z
مرعش	m r ʔ ʃ
مرغابی	m r ɣ a b iː
مرغی	m r ɣ iː
مرمت	m r m t
مرنا	m r n a
مروانا	m r uː a n a
مرکز	m r k z
مرکزی	m r k z iː
مریدکے	m r iː d k eː
مریض	m r iː z
مریم	m r iː m
مزاج	m z a dʒ
مزاحمت	m z a h m t
مزدور	m z d uː r
مزور	m z uː r
مزہ	m z h
مزید	m z iː d
مزیدار	m z iː d a r
مسئلہ	m s ʔ l h
مسئلہ	m s ʔ l h
مسئلہ	m s ʔ l h
مسافر	m s a f r
مستراح	m s t r a h
مسترد	m s t r d
مستعفی	m s t ʔ f iː
مستقبل	m s t q b l
مستقر	m s t q r
مستونگ	m s t uː n ɡ
مسجد	m s dʒ d
مسقط	m s q t
مسلسل	m s l s l
مسلمان	m s l m a n
مسلمہ	m s l m h
مسود	m s uː d
مسیح	m s iː h
مسیحا	m s iː h a
مسیحی	m s iː h iː
مسیحیت	m s iː h iː t
مشترکہ	m ʃ t r k h
مشترکہ	m ʃ t r k h
مشرق	m ʃ r q
مشرک	m ʃ r k
مشعل	m ʃ ʔ l
مشغلہ	m ʃ ɣ l h
مشغول	m ʃ ɣ uː l
مشق	m ʃ q
مشقت	m ʃ q t
مشوروں	m ʃ uː r uː ŋ
مشورہ	m ʃ uː r h
مشورہ	m ʃ uː r h
مشورے	m ʃ uː r eː
مشک	m ʃ k
مشکل	m ʃ k l
مشہد	m ʃ h d
مشہور	m ʃ h uː r
مشہوری	m ʃ h uː r iː
مصالحہ	m s a l h h
مصالحہ	m s a l h h
مصالحہ	m s a l h h
مصر	m s r
مصر	m s r
مصروف	m s r uː f
مصری	m s r iː
مصنف	m s n f
مصیبت	m s iː b t
مضموم	m z m uː m
مضمون	m z m uː n
مطالعہ	m t a l ʔ h
مطعم	m t ʔ m
مطلب	m t l b
مطلقا	m t l q a
مظاہرہ	m z a h r h
مظاہرین	m z a h r iː n
مظلوم	m z l uː m
مع	m ʔ
معاش	m ʔ a ʃ
معاشرہ	m ʔ a ʃ r h
معاصر	m ʔ a s r
معاملہ	m ʔ a m l h
معاملہ	m ʔ a m l h
معاہدہ	m ʔ a h d h
معبد	m ʔ b d
معبد	m ʔ b d
معبود	m ʔ b uː d
معتمد	m ʔ t m d
معجزہ	m ʔ dʒ z h
معجزہ	m ʔ dʒ z h
معذرت	m ʔ z r t
معذور	m ʔ z uː r
معروف	m ʔ r uː f
معرکہ	m ʔ r k h
معطل	m ʔ t l
معلم	m ʔ l m
معلم	m ʔ l m
معلوم	m ʔ l uː m
معمار	m ʔ m a r
معماری	m ʔ m a r iː
معمر	m ʔ m r
معمر	m ʔ m r
معمول	m ʔ m uː l
معیار	m ʔ iː a r
معیار	m ʔ iː a r
معیاری	m ʔ iː a r iː
معیشت	m ʔ iː ʃ t
مغل	m ɣ l
مغلوط	m ɣ l uː t
مفاہمت	m f a h m t
مفت	m f t
مفتوح	m f t uː h
مفتی	m f t iː
مفہوم	m f h uː m
مقامی	m q a m iː
مقامی	m q a m iː
مقبوض	m q b uː z
مقبوضہ	m q b uː z h
مقبول	m q b uː l
مقتل	m q t l
مقدار	m q d a r
مقدسہ	m q d s h
مقدونی	m q d uː n iː
مقصد	m q s d
مقناطيس	m q n a t s
مقناطيس	m q n a t s
مقناطیس	m q n a t iː s
مقناطیس	m q n a t iː s
مقیم	m q iː m
ملائیشیا	m l a ʔ iː ʃ iː a
ملاحظہ	m l a h z h
ملازمت	m l a z m t
ملازمت	m l a z m t
ملاقات	m l a q a t
ملامت	m l a m t
ملانا	m l a n a
ملتان	m l t a n
ملتانی	m l t a n iː
ملزم	m l z m
ململ	m l m l
ملن	m l n
ملن	m l n
ملنا	m l n a
ملنا	m l n a
ملنسار	m l n s a r
ملنگ	m l n ɡ
ملوث	m l uː s
ملک	m l k
ملک	m l k
ملکہ	m l k h
ملکہ	m l k h
ملی	m l iː
ملی	m l iː
ملیامیٹ	m l iː a m iː ʈ
ملیامیٹ	m l iː a m iː ʈ
ممالک	m m a l k
ممبئی	m m b ʔ iː
ممباسہ	m m b a s h
مملکت	m m l k t
ممنوع	m m n uː ʔ
ممکن	m m k n
مناسب	m n a s b
مناسبت	m n a s b t
مناظر	m n a z r
منانا	m n a n a
منتخب	m n t x b
منتر	m n t r
منتظم	m n t z m
منحوس	m n h uː s
مندر	m n d r
منزل	m n z l
منسلک	m n s l k
منسوخ	m n s uː x
منشور	m n ʃ uː r
منشی	m n ʃ iː
منشی	m n ʃ iː
منشیات	m n ʃ iː a t
منشیہ	m n ʃ iː h
منصوبہ	m n s uː b h
منظر	m n z r
منظم	m n z m
منظور	m n z uː r
منع	m n ʔ
منع	m n ʔ
منقطع	m n q t ʔ
منٹ	m n ʈ
منڈا	m n ɖ a
منکر	m n k r
منگنی	m n ɡ n iː
منگوانا	m n ɡ uː a n a
منگوانا	m n ɡ uː a n a
منگیتر	m n ɡ iː t r
منہ	m n h
منی	m n iː
منیت	m n iː t
منیت	m n iː t
مواصلات	m uː a s l a t
مواصلات	m uː a s l a t
مواصلات	m uː a s l a t
مواقع	m uː a q ʔ
موج	m uː dʒ
موجود	m uː dʒ uː d
موجود	m uː dʒ uː d
موجودگی	m uː dʒ uː d ɡ iː
موجودگی	m uː dʒ uː d ɡ iː
موجودہ	m uː dʒ uː d h
مورت	m uː r t
مورتی	m uː r t iː
مورمن	m uː r m n
موز	m uː z
موزمبیق	m uː z m b iː q
موسم	m uː s m
موسوم	m uː s uː m
موسی	m uː s iː
موسیقار	m uː s iː q a r
موسیقی	m uː s iː q iː
موضوع	m uː z uː ʔ
موقع	m uː q ʔ
مول	m uː l
مولا	m uː l a
مولود	m uː l uː d
مومن	m uː m n
مونٹینیگرو	m uː n ʈ iː n iː ɡ r uː
موٹا	m uː ʈ a
موٹی	m uː ʈ iː
مویشی	m uː j ʃ iː
مٹانا	m ʈ a n a
مٹنا	m ʈ n a
مٹھی	m ʈ ʰ iː
مچھ	m tʃ ʰ
مچھر	m tʃ ʰ r
مچھلی	m tʃ ʰ l iː
مژگانی	m ʒ ɡ a n iː
مکان	m k a n
مکتب	m k t b
مکروہ	m k r uː h
مکسور	m k s uː r
مکھ	m k ʰ
مکھن	m k ʰ n
مکھڑا	m k ʰ ɽ a
مکہ	m k h
مگرمچھ	m ɡ r m tʃ ʰ
مہابھارت	m h a b ʰ a r t
مہاجر	m h a dʒ r
مہاجر	m h a dʒ r
مہاجرت	m h a dʒ r t
مہاجرت	m h a dʒ r t
مہاجرین	m h a dʒ r iː n
مہاجرین	m h a dʒ r iː n
مہاراشٹر	m h a r a ʃ ʈ r
مہاراشٹر	m h a r a ʃ ʈ r
مہارانی	m h a r a n iː
مہارت	m h a r t
مہان	m h a n
مہاوت	m h a ʋ t
مہر	m h r
مہر	m h r
مہر	m h r
مہر	m h r
مہران	m h r a n
مہران	m h r a n
مہربان	m h r b a n
مہربان	m h r b a n
مہمان	m h m a n
مہمان	m h m a n
مہمان	m h m a n
مہمانی	m h m a n iː
مہندس	m h n d s
مہندی	m h n d iː
مہندی	m h n d iː
مہندی	m h n d iː
مہندی	m h n d iː
مہنڈر	m h n ɖ r
مہنگا	m h n ɡ a
مہنگا	m h n ɡ a
مہنگائی	m h n ɡ a ʔ iː
مہیلا	m h iː l a
مہینا	m h iː n a
مہینہ	m h iː n h
میانمار	m iː a n m a r
میانوالی	m iː a n uː a l iː
میاں	m iː a ŋ
میتھن	m iː t ʰ n
میدان	m iː d a n
میرا	m iː r a
میرپور	m iː r p uː r
میز	m iː z
میزان	m iː z a n
میزبان	m iː z b a n
میزورم	m iː z uː r m
میغ	m iː ɣ
میغ	m iː ɣ
میل	m iː l
مینو	m iː n uː
مینڈھر	m iː n ɖ ʰ r
مینڈھک	m iː n ɖ ʰ k
مینگورہ	m iː n ɡ uː r h
مینہ	m iː n h
میور	m iː ʋ r
میونخ	m iː ʋ n x
میوہ	m iː ʋ h
میٹھا	m iː ʈ ʰ a
میکائیل	m iː k a ʔ iː l
میکسیکو	m iː k s iː k uː
میگھ	m iː ɡ ʰ
میگھالیہ	m iː ɡ ʰ a l iː h
میں	m iː ŋ
میں	m iː ŋ
مے	m eː
ن	n
ن	n
ن	n
ن	n
ن	n
نئی	n ʔ iː
نا	n a
نائی	n a ʔ iː
نائیجیریا	n a ʔ iː dʒ iː r iː a
ناخدا	n a x d a
ناخن	n a x n
نادان	n a d a n
ناراض	n a r a z
نارنجی	n a r n dʒ iː
نارنگی	n a r n ɡ iː
نارووال	n a r uː ʋ a l
ناروے	n a r uː eː
ناز	n a z
نازل	n a z l
نازک	n a z k
ناستک	n a s t k
ناشتا	n a ʃ t a
ناشر	n a ʃ r
ناصر	n a s r
ناصرت	n a s r t
ناصرہ	n a s r h
ناظر	n a z r
ناظم	n a z m
ناف	n a f
نافرمان	n a f r m a n
نافرمانبرداری	n a f r m a n b r d a r iː
ناقوس	n a q uː s
نال	n a l
نالی	n a l iː
نام	n a m
ناممکن	n a m m k n
نامہ	n a m h
نامی	n a m iː
نان	n a n
نانا	n a n a
نانگل	n a n ɡ l
نانی	n a n iː
ناچ	n a tʃ
ناچنا	n a tʃ n a
ناک	n a k
ناکام	n a k a m
ناگ	n a ɡ
ناگالینڈ	n a ɡ a l iː n ɖ
ناگرک	n a ɡ r k
ناہر	n a h r
نایاب	n a j a b
نباتیات	n b a t iː a t
نبض	n b z
نبھانا	n b ʰ a n a
نتیجتا	n t iː dʒ t a
نتیجہ	n t iː dʒ h
نثر	n s r
نجبا	n dʒ b a
نجی	n dʒ iː
نجیب	n dʒ iː b
نخرا	n x r a
نخست	n x s t
نخچیر	n x tʃ iː r
ندرشن	n d r ʃ n
ندی	n d iː
ندیاں	n d iː a ŋ
ندیو	n d iː ʋ
ندیوں	n d iː ʋ ŋ
نر	n r
نردوش	n r d uː ʃ
نرمان	n r m a n
نرنایک	n r n a j k
نرگس	n r ɡ s
نزاکت	n z a k t
نزدیکی	n z d iː k iː
نزہت	n z h t
نساء	n s a ʔ
نسبتا	n s b t a
نستعلیق	n s t ʔ l iː q
نسخ	n s x
نسخہ	n s x h
نسل	n s l
نشان	n ʃ a n
نشانی	n ʃ a n iː
نشریات	n ʃ r iː a t
نشریہ	n ʃ r iː h
نشست	n ʃ s t
نشور	n ʃ uː r
نشچت	n ʃ tʃ t
نصاب	n s a b
نصاری	n s a r iː
نصرانی	n s r a n iː
نصرت	n s r t
نصیب	n s iː b
نظارہ	n z a r h
نظام	n z a m
نظامت	n z a m t
نظر	n z r
نظریہ	n z r iː h
نظم	n z m
نظم	n z m
نظیف	n z iː f
نعت	n ʔ t
نعرہ	n ʔ r h
نعمت	n ʔ m t
نعمت	n ʔ m t
نغمہ	n ɣ m h
نفاذ	n f a z
نفاق	n f a q
نفرت	n f r t
نقاب	n q a b
نقاب	n q a b
نقصان	n q s a n
نقطہ	n q t h
نقلی	n q l iː
نماز	n m a z
نماز	n m a z
نمبو	n m b uː
نمستے	n m s t eː
نمونہ	n m uː n h
نمک	n m k
نمکین	n m k iː n
نمی	n m iː
نن	n n
ننگا	n n ɡ a
ننھا	n n ʰ a
نو	n uː
نوآبادیاتی	n uː ɑː b a d iː a t iː
نوابشاہ	n uː a b ʃ a h
نوبت	n uː b t
نوح	n uː h
نور	n uː r
نوش	n uː ʃ
نوشکی	n uː ʃ k iː
نوشہرہ	n uː ʃ h r h
نوشی	n uː ʃ iː
نوواں	n uː ʋ a ŋ
نوکر	n uː k r
نوکرانی	n uː k r a n iː
نوکری	n uː k r iː
نوید	n uː j d
نوید	n uː j d
نویدن	n uː j d n
نویس	n uː j s
نویسندہ	n uː j s n d h
نویسندہ	n uː j s n d h
نيت	n t
نپولین	n p uː l iː n
نژاد	n ʒ a d
نژاد	n ʒ a d
نکاح	n k a h
نکاراتمک	n k a r a t m k
نکالنا	n k a l n a
نکسیر	n k s iː r
نکما	n k m a
نگاہ	n ɡ a h
نگر	n ɡ r
نگرانی	n ɡ r a n iː
نہ	n h
نہ	n h
نہاد	n h a d
نہایت	n h a j t
نہضت	n h z t
نہیں	n h iː ŋ
نیا	n iː a
نیر	n iː r
نیز	n iː z
نیم	n iː m
نیم	n iː m
نیم	n iː m
نین	n iː n
نیند	n iː n d
نیوجن	n iː ʋ dʒ n
نیپال	n iː p a l
نیک	n iː k
نے	n eː
و	ʋ
و	ʋ
و	ʋ
و	ʋ
و	ʋ
و	ʋ
وا	ʋ a
وابستگی	ʋ a b s t ɡ iː
واحد	ʋ a h d
وادی	ʋ a d iː
وار	ʋ a r
وارانسی	ʋ a r a n s iː
وارد	ʋ a r d
واسط	ʋ a s t
واسطہ	ʋ a s t h
واسع	ʋ a s ʔ
واسی	ʋ a s iː
واشک	ʋ a ʃ k
واقعات	ʋ a q ʔ a t
واقعہ	ʋ a q ʔ h
واقف	ʋ a q f
والد	ʋ a l d
والدہ	ʋ a l d h
والدین	ʋ a l d iː n
والدین	ʋ a l d iː n
وامن	ʋ a m n
واپس	ʋ a p s
واکیہ	ʋ a k iː h
واہ	ʋ a h
واہک	ʋ a h k
وبھاجن	ʋ b ʰ a dʒ n
وبھاگ	ʋ b ʰ a ɡ
وتر	ʋ t r
وتر	ʋ t r
ودھان	ʋ d ʰ a n
ودھوا	ʋ d ʰ uː a
ودیارتھی	ʋ d iː a r t ʰ iː
ورزش	ʋ r z ʃ
ورودھ	ʋ r uː d ʰ
وزارت	ʋ z a r t
وزرا	ʋ z r a
وزیر	ʋ z iː r
وستو	ʋ s t uː
وسنت	ʋ s n t
وشنو	ʋ ʃ n uː
وصال	ʋ s a l
وضو	ʋ z uː
وضو	ʋ z uː
وفا	ʋ f a
وفاق	ʋ f a q
وفاق	ʋ f a q
وفد	ʋ f d
وفد	ʋ f d
وقار	ʋ q a r
وقف	ʋ q f
وقوع	ʋ q uː ʔ
ولایت	ʋ l a j t
ولایتی	ʋ l a j t iː
ولد	ʋ l d
ولندیز	ʋ l n d iː z
ولی	ʋ l iː
ونا	ʋ n a
وندر	ʋ n d r
ونشج	ʋ n ʃ dʒ
وواد	ʋ ʋ a d
وچن	ʋ tʃ n
وڈھ	ʋ ɖ ʰ
وکھیات	ʋ k ʰ iː a t
وگیان	ʋ ɡ iː a n
وہ	ʋ h
وہاڑی	ʋ h a ɽ iː
وہاں	ʋ h a ŋ
وہی	ʋ h iː
ویتنام	ʋ j t n a m
ویر	ʋ j r
ویران	ʋ j r a n
وینجن	ʋ j n dʒ n
وینیزویلا	ʋ j n iː z uː j l a
ویژن	ʋ j ʒ n
وے	ʋ eː
ٹ	ʈ
ٹ	ʈ
ٹالنا	ʈ a l n a
ٹانگ	ʈ a n ɡ
ٹاپو	ʈ a p uː
ٹرام	ʈ r a m
ٹرو	ʈ r uː
ٹرک	ʈ r k
ٹریکٹر	ʈ r iː k ʈ r
ٹریکٹر	ʈ r iː k ʈ r
ٹلفورڈ	ʈ l f uː r ɖ
ٹماٹر	ʈ m a ʈ r
ٹوٹا	ʈ uː ʈ a
ٹوٹنا	ʈ uː ʈ n a
ٹوٹی	ʈ uː ʈ iː
ٹوپی	ʈ uː p iː
ٹٹی	ʈ ʈ iː
ٹکر	ʈ k r
ٹکراو	ʈ k r a ʋ
ٹکٹ	ʈ k ʈ
ٹھرکی	ʈ ʰ r k iː
ٹھنڈا	ʈ ʰ n ɖ a
ٹھوس	ʈ ʰ uː s
ٹھوڑی	ʈ ʰ uː ɽ iː
ٹھڈی	ʈ ʰ ɖ iː
ٹھکانا	ʈ ʰ k a n a
ٹھہرنا	ʈ ʰ h r n a
ٹھہرنا	ʈ ʰ h r n a
ٹھیلا	ʈ ʰ iː l a
ٹھیکا	ʈ ʰ iː k a
ٹھیکیدار	ʈ ʰ iː k iː d a r
ٹینگی	ʈ iː n ɡ iː
ٹیپ	ʈ iː p
ٹیکسلا	ʈ iː k s l a
ٹیکسی	ʈ iː k s iː
پ	p
پ	p
پاؤں	p a ʔ ŋ
پاؤں	p a ʔ ŋ
پائپ	p a ʔ p
پاد	p a d
پادری	p a d r iː
پارسی	p a r s iː
پارچہ	p a r tʃ h
پاسبان	p a s b a n
پاستا	p a s t a
پاسپورٹ	p a s p uː r ʈ
پال	p a l
پالتو	p a l t uː
پالم	p a l m
پالنا	p a l n a
پالک	p a l k
پان	p a n
پانا	p a n a
پانو	p a n uː
پانو	p a n uː
پانچ	p a n tʃ
پانچواں	p a n tʃ uː a ŋ
پانڈو	p a n ɖ uː
پانہ	p a n h
پانی	p a n iː
پاٹھک	p a ʈ ʰ k
پاپ	p a p
پاکستان	p a k s t a n
پاکستانی	p a k s t a n iː
پاکپتن	p a k p t n
پتا	p t a
پتا	p t a
پتری	p t r iː
پتلون	p t l uː n
پتنگ	p t n ɡ
پتنی	p t n iː
پتھر	p t ʰ r
پتہ	p t h
پتی	p t iː
پتی	p t iː
پد	p d
پدر	p d r
پذیر	p z iː r
پر	p r
پراتن	p r a t n
پرانت	p r a n t
پراٹھا	p r a ʈ ʰ a
پراپت	p r a p t
پراچین	p r a tʃ iː n
پراکرت	p r a k r t
پربھات	p r b ʰ a t
پرتگال	p r t ɡ a l
پرتگال	p r t ɡ a l
پرتگیا	p r t ɡ iː a
پردوں	p r d uː ŋ
پردہ	p r d h
پردیش	p r d iː ʃ
پردے	p r d eː
پرزہ	p r z h
پرستان	p r s t a n
پرستش	p r s t ʃ
پرسوں	p r s uː ŋ
پرش	p r ʃ
پرش	p r ʃ
پرشنسا	p r ʃ n s a
پرشیا	p r ʃ iː a
پرمکھ	p r m k ʰ
پرمیشور	p r m iː ʃ uː r
پرمیشور	p r m iː ʃ uː r
پرندہ	p r n d h
پرندہ	p r n d h
پرنی	p r n iː
پروا	p r uː a
پروار	p r uː a r
پروت	p r uː t
پروردگار	p r uː r d ɡ a r
پروردگار	p r uː r d ɡ a r
پرورش	p r uː r ʃ
پرول	p r uː l
پرونا	p r uː n a
پرچار	p r tʃ a r
پرچم	p r tʃ m
پرچہ	p r tʃ h
پرچہ	p r tʃ h
پرچی	p r tʃ iː
پرکاش	p r k a ʃ
پرکاشک	p r k a ʃ k
پرکھ	p r k ʰ
پرکھیات	p r k ʰ iː a t
پری	p r iː
پریت	p r iː t
پریت	p r iː t
پریت	p r iː t
پریشان	p r iː ʃ a n
پریم	p r iː m
پریم	p r iː m
پریڈ	p r iː ɖ
پریکشا	p r iː k ʃ a
پریکشائیں	p r iː k ʃ a ʔ iː ŋ
پستان	p s t a n
پستک	p s t k
پستہ	p s t h
پسر	p s r
پسند	p s n d
پسنی	p s n iː
پسو	p s uː
پسو	p s uː
پسینہ	p s iː n h
پشاور	p ʃ a ʋ r
پشتو	p ʃ t uː
پشپ	p ʃ p
پشچم	p ʃ tʃ m
پشین	p ʃ iː n
پل	p l
پل	p l
پلانڈو	p l a n ɖ uː
پلنگ	p l n ɡ
پلٹنا	p l ʈ n a
پنا	p n a
پناہ	p n a h
پنجاب	p n dʒ a b
پنجابی	p n dʒ a b iː
پنجہ	p n dʒ h
پنسل	p n s l
پنسل	p n s l
پنچھی	p n tʃ ʰ iː
پنڈال	p n ɖ a l
پنکھ	p n k ʰ
پنکھا	p n k ʰ a
پنکھڑی	p n k ʰ ɽ iː
پنگھٹ	p n ɡ ʰ ʈ
پنیر	p n iː r
پنیہ	p n iː h
پنیہ	p n iː h
پوت	p uː t
پوجا	p uː dʒ a
پوجنا	p uː dʒ n a
پوجک	p uː dʒ k
پور	p uː r
پورا	p uː r a
پوربی	p uː r b iː
پوست	p uː s t
پوشاک	p uː ʃ a k
پولس	p uː l s
پولس	p uː l s
پولینڈ	p uː l iː n ɖ
پون	p uː n
پونچھ	p uː n tʃ ʰ
پوپ	p uː p
پوپ	p uː p
پوچھنا	p uː tʃ ʰ n a
پٹاخا	p ʈ a x a
پٹل	p ʈ l
پٹواری	p ʈ uː a r iː
پٹواری	p ʈ uː a r iː
پٹول	p ʈ uː l
پٹھان	p ʈ ʰ a n
پٹی	p ʈ iː
پپاسا	p p a s a
پچھتر	p tʃ ʰ t r
پچھواڑا	p tʃ ʰ uː a ɽ a
پڑوسی	p ɽ uː s iː
پڑھائی	p ɽ ʰ a ʔ iː
پڑھنا	p ɽ ʰ n a
پژمردگی	p ʒ m r d ɡ iː
پژوہش	p ʒ uː h ʃ
پکا	p k a
پکار	p k a r
پکنا	p k n a
پھانسی	p ʰ a n s iː
پھدی	p ʰ d iː
پھریرے	p ʰ r iː r eː
پھل	p ʰ l
پھلنا	p ʰ l n a
پھول	p ʰ uː l
پھوپھا	p ʰ uː p ʰ a
پھوڑا	p ʰ uː ɽ a
پھیرا	p ʰ iː r a
پھیلاو	p ʰ iː l a ʋ
پھینکنا	p ʰ iː n k n a
پھینکنا	p ʰ iː n k n a
پہ	p h
پہاڑ	p h a ɽ
پہلا	p h l a
پہلوان	p h l uː a n
پہنچنا	p h n tʃ n a
پہنچنا	p h n tʃ n a
پہچان	p h tʃ a n
پہیا	p h iː a
پہیا	p h iː a
پیادہ	p iː a d h
پیار	p iː a r
پیار	p iː a r
پیارا	p iː a r a
پیاز	p iː a z
پیاس	p iː a s
پیج	p iː dʒ
پیدا	p iː d a
پیدائش	p iː d a ʔ ʃ
پیر	p iː r
پیر	p iː r
پیرس	p iː r s
پیرو	p iː r uː
پیرو	p iː r uː
پیروی	p iː r uː j
پیش	p iː ʃ
پیشاب	p iː ʃ a b
پیشگوئی	p iː ʃ ɡ uː ʔ iː
پیغام	p iː ɣ a m
پیغمبر	p iː ɣ m b r
پیمان	p iː m a n
پینا	p iː n a
پینسل	p iː n s l
پیٹ	p iː ʈ
پیڑ	p iː ɽ
چ	tʃ
چ	tʃ
چا	tʃ a
چائے	tʃ a ʔ eː
چابھی	tʃ a b ʰ iː
چابی	tʃ a b iː
چادر	tʃ a d r
چار	tʃ a r
چارسدہ	tʃ a r s d h
چاشت	tʃ a ʃ t
چاشنی	tʃ a ʃ n iː
چاق	tʃ a q
چاقو	tʃ a q uː
چال	tʃ a l
چالک	tʃ a l k
چاند	tʃ a n d
چاند	tʃ a n d
چاندی	tʃ a n d iː
چاندی	tʃ a n d iː
چانٹا	tʃ a n ʈ a
چاول	tʃ a ʋ l
چاٹ	tʃ a ʈ
چاٹنا	tʃ a ʈ n a
چاٹگام	tʃ a ʈ ɡ a m
چاک	tʃ a k
چاہت	tʃ a h t
چاہنا	tʃ a h n a
چاہے	tʃ a h eː
چای	tʃ a j
چتکان	tʃ t k a n
چراغ	tʃ r a ɣ
چراغ	tʃ r a ɣ
چراک	tʃ r a k
چربی	tʃ r b iː
چرخہ	tʃ r x h
چرس	tʃ r s
چرپرا	tʃ r p r a
چرچ	tʃ r tʃ
چشتیاں	tʃ ʃ t iː a ŋ
چشم	tʃ ʃ m
چشمک	tʃ ʃ m k
چشمہ	tʃ ʃ m h
چغتائی	tʃ ɣ t a ʔ iː
چفتی	tʃ f t iː
چق	tʃ q
چقماق	tʃ q m a q
چقمق	tʃ q m q
چكی	tʃ k iː
چلاس	tʃ l a s
چلانا	tʃ l a n a
چلانا	tʃ l a n a
چلاہٹ	tʃ l a h ʈ
چلن	tʃ l n
چلنا	tʃ l n a
چلون	tʃ l uː n
چلچتر	tʃ l tʃ t r
چماٹ	tʃ m a ʈ
چمن	tʃ m n
چمو	tʃ m uː
چمچ	tʃ m tʃ
چمچہ	tʃ m tʃ h
چمکار	tʃ m k a r
چنئی	tʃ n ʔ iː
چناب	tʃ n a b
چنتا	tʃ n t a
چندر	tʃ n d r
چندربند	tʃ n d r b n d
چنگال	tʃ n ɡ a l
چنیوٹ	tʃ n iː ʋ ʈ
چوبے	tʃ uː b eː
چوت	tʃ uː t
چوتر	tʃ uː t r
چوتڑ	tʃ uː t ɽ
چوتھا	tʃ uː t ʰ a
چوتھائی	tʃ uː t ʰ a ʔ iː
چود	tʃ uː d
چودنا	tʃ uː d n a
چودہ	tʃ uː d h
چودہ	tʃ uː d h
چور	tʃ uː r
چورنگی	tʃ uː r n ɡ iː
چوری	tʃ uː r iː
چول	tʃ uː l
چولھا	tʃ uː l ʰ a
چولھا	tʃ uː l ʰ a
چومنا	tʃ uː m n a
چونا	tʃ uː n a
چوٹ	tʃ uː ʈ
چوپان	tʃ uː p a n
چوپان	tʃ uː p a n
چوپان	tʃ uː p a n
چوڑا	tʃ uː ɽ a
چوڑائی	tʃ uː ɽ a ʔ iː
چوڑی	tʃ uː ɽ iː
چوک	tʃ uː k
چوکی	tʃ uː k iː
چوکیدار	tʃ uː k iː d a r
چوگنا	tʃ uː ɡ n a
چوہا	tʃ uː h a
چٹکی	tʃ ʈ k iː
چٹکی	tʃ ʈ k iː
چٹگاؤں	tʃ ʈ ɡ a ʔ ŋ
چپ	tʃ p
چپاتی	tʃ p a t iː
چپقلش	tʃ p q l ʃ
چپل	tʃ p l
چپٹی	tʃ p ʈ iː
چچی	tʃ tʃ iː
چڑھانا	tʃ ɽ ʰ a n a
چڑھنا	tʃ ɽ ʰ n a
چڑیا	tʃ ɽ iː a
چڑیل	tʃ ɽ iː l
چڑیل	tʃ ɽ iː l
چکت	tʃ k t
چکمہ	tʃ k m h
چکنا	tʃ k n a
چکنا	tʃ k n a
چکنا	tʃ k n a
چکنگنیا	tʃ k n ɡ n iː a
چکوال	tʃ k uː a l
چکھنا	tʃ k ʰ n a
چگونہ	tʃ ɡ uː n h
چھ	tʃ ʰ
چھاؤنی	tʃ ʰ a ʔ n iː
چھاؤں	tʃ ʰ a ʔ ŋ
چھاتر	tʃ ʰ a t r
چھال	tʃ ʰ a l
چھاپنا	tʃ ʰ a p n a
چھاپہ	tʃ ʰ a p h
چھایا	tʃ ʰ a j a
چھت	tʃ ʰ t
چھتری	tʃ ʰ t r iː
چھلانگ	tʃ ʰ l a n ɡ
چھلکا	tʃ ʰ l k a
چھوارے	tʃ ʰ uː a r eː
چھونا	tʃ ʰ uː n a
چھوٹ	tʃ ʰ uː ʈ
چھوٹا	tʃ ʰ uː ʈ a
چھوٹنا	tʃ ʰ uː ʈ n a
چھٹا	tʃ ʰ ʈ a
چھٹا	tʃ ʰ ʈ a
چھٹپٹانا	tʃ ʰ ʈ p ʈ a n a
چھٹی	tʃ ʰ ʈ iː
چھپانا	tʃ ʰ p a n a
چھپنا	tʃ ʰ p n a
چھپکلی	tʃ ʰ p k l iː
چھڑکاؤ	tʃ ʰ ɽ k a ʔ
چھکا	tʃ ʰ k a
چھہ	tʃ ʰ h
چھینک	tʃ ʰ iː n k
چہارم	tʃ h a r m
چہرہ	tʃ h r h
چہرہ	tʃ h r h
چیخ	tʃ iː x
چیز	tʃ iː z
چیل	tʃ iː l
چیلینجی	tʃ iː l iː n dʒ iː
چین	tʃ iː n
چین	tʃ iː n
چین	tʃ iː n
چینٹی	tʃ iː n ʈ iː
چینٹی	tʃ iː n ʈ iː
چینی	tʃ iː n iː
چیونٹی	tʃ iː ʋ n ʈ iː
چیونٹی	tʃ iː ʋ n ʈ iː
چیچنیا	tʃ iː tʃ n iː a
چیچنیا	tʃ iː tʃ n iː a
ڈ	ɖ
ڈ	ɖ
ڈالنا	ɖ a l n a
ڈاڈو	ɖ a ɖ uː
ڈاک	ɖ a k
ڈاکو	ɖ a k uː
ڈاکٹر	ɖ a k ʈ r
ڈاکیہ	ɖ a k iː h
ڈبہ	ɖ b h
ڈبہ	ɖ b h
ڈرنا	ɖ r n a
ڈسکہ	ɖ s k h
ڈمبوداس	ɖ m b uː d a s
ڈمرو	ɖ m r uː
ڈنکرک	ɖ n k r k
ڈنکی	ɖ n k iː
ڈوری	ɖ uː r iː
ڈونگا	ɖ uː n ɡ a
ڈوور	ɖ uː ʋ r
ڈچ	ɖ tʃ
ڈڑھیل	ɖ ɽ ʰ iː l
ڈکار	ɖ k a r
ڈکار	ɖ k a r
ڈکی	ɖ k iː
ڈگمگانا	ɖ ɡ m ɡ a n a
ڈگی	ɖ ɡ iː
ڈھانپنا	ɖ ʰ a n p n a
ڈھانچہ	ɖ ʰ a n tʃ h
ڈھاکہ	ɖ ʰ a k h
ڈھول	ɖ ʰ uː l
ڈھولک	ɖ ʰ uː l k
ڈھونڈنا	ɖ ʰ uː n ɖ n a
ڈھونڈھ	ɖ ʰ uː n ɖ ʰ
ڈھيٹ	ɖ ʰ ʈ
ڈھکن	ɖ ʰ k n
ڈہرکی	ɖ h r k iː
ڈیرہ	ɖ iː r h
ڈیوڑھی	ɖ iː ʋ ɽ ʰ iː
ڈیٹابیس	ɖ iː ʈ a b iː s
ڈیٹھ	ɖ iː ʈ ʰ
ڑ	ɽ
ڑ	ɽ
ژ	ʒ
ژ	ʒ
ژالہ	ʒ a l h
ژوب	ʒ uː b
ژیان	ʒ iː a n
ژیاں	ʒ iː a ŋ
ک	k
ک	k
کائنات	k a ʔ n a t
کابل	k a b l
کابوس	k a b uː s
کاتھولک	k a t ʰ uː l k
کارا	k a r a
کارخانہ	k a r x a n h
کارروائی	k a r r uː a ʔ iː
کارزار	k a r z a r
کارن	k a r n
کاروبار	k a r uː b a r
کارٹون	k a r ʈ uː n
کارکردگی	k a r k r d ɡ iː
کاشغر	k a ʃ ɣ r
کاغذ	k a ɣ z
کاغذات	k a ɣ z a t
کالا	k a l a
کالج	k a l dʒ
کالسروئے	k a l s r uː ʔ eː
کام	k a m
کامل	k a m l
کامونکے	k a m uː n k eː
کامیاب	k a m iː a b
کان	k a n
کانٹا	k a n ʈ a
کانپنا	k a n p n a
کاویہ	k a ʋ j h
کاڑھا	k a ɽ ʰ a
کاہکشان	k a h k ʃ a n
کب	k b
کبابیر	k b a b iː r
کباڑ	k b a ɽ
کبج	k b dʒ
کبریت	k b r iː t
کبل	k b l
کبھو	k b ʰ uː
کبھی	k b ʰ iː
کبیر	k b iː r
کتا	k t a
کتاب	k t a b
کتراپی	k t r a p iː
کتره	k t r
کتھن	k t ʰ n
کتی	k t iː
کثرت	k s r t
کدو	k d uː
کدو	k d uː
کر	k r
کراچوی	k r a tʃ uː j
کراچی	k r a tʃ iː
کردستان	k r d s t a n
کردن	k r d n
کردنت	k r d n t
کرسی	k r s iː
کرشمہ	k r ʃ m h
کرغیزستان	k r ɣ iː z s t a n
کرم	k r m
کرن	k r n
کرنا	k r n a
کرناٹک	k r n a ʈ k
کرو	k r uː
کرو	k r uː
کروانا	k r uː a n a
کرکٹ	k r k ʈ
کرکٹ	k r k ʈ
کری	k r iː
کریم	k r iː m
کس	k s
کسان	k s a n
کسی	k s iː
کشتی	k ʃ t iː
کشتی	k ʃ t iː
کشدھا	k ʃ d ʰ a
کشما	k ʃ m a
کشمیر	k ʃ m iː r
کشندہ	k ʃ n d h
کشور	k ʃ uː r
کشور	k ʃ uː r
کشور	k ʃ uː r
کشٹ	k ʃ ʈ
کشیدگی	k ʃ iː d ɡ iː
کعبہ	k ʔ b h
کلاشنکوف	k l a ʃ n k uː f
کلام	k l a m
کلاونت	k l a ʋ n t
کلاں	k l a ŋ
کلب	k l b
کلب	k l b
کلمہ	k l m h
کلو	k l uː
کلیان	k l iː a n
کلیجا	k l iː dʒ a
کلیسیا	k l iː s iː a
کلیہ	k l iː h
کلیہ	k l iː h
کم	k m
کمائی	k m a ʔ iː
کمال	k m a l
کمالیہ	k m a l iː h
کمان	k m a n
کمانا	k m a n a
کمبل	k m b l
کمبوڈیا	k m b uː ɖ iː a
کمر	k m r
کمرہ	k m r h
کمری	k m r iː
کمل	k m l
کملا	k m l a
کملائی	k m l a ʔ iː
کمپ	k m p
کمپت	k m p t
کمپن	k m p n
کمپیوٹر	k m p iː ʋ ʈ r
کمھڑا	k m ʰ ɽ a
کمھڑا	k m ʰ ɽ a
کمی	k m iː
کمیاب	k m iː a b
کمینہ	k m iː n h
کمیٹی	k m iː ʈ iː
کنارہ	k n a r h
کنجی	k n dʒ iː
کندرا	k n d r a
کندھا	k n d ʰ a
کنعان	k n ʔ a n
کنفیوشس	k n f iː ʋ ʃ s
کنواری	k n uː a r iː
کنور	k n uː r
کنور	k n uː r
کنور	k n uː r
کنٹرول	k n ʈ r uː l
کنڑ	k n ɽ
کنکال	k n k a l
کنگارو	k n ɡ a r uː
کنگھی	k n ɡ ʰ iː
کنیز	k n iː z
کنیسہ	k n iː s h
کو	k uː
کوئٹہ	k uː ʔ ʈ h
کوئی	k uː ʔ iː
کوا	k uː a
کوا	k uː a
کوتا	k uː t a
کورو	k uː r uː
کورو	k uː r uː
کوشش	k uː ʃ ʃ
کوفی	k uː f iː
کوفی	k uː f iː
کولر	k uː l r
کولمبیا	k uː l m b iː a
کولن	k uː l n
کون	k uː n
کوٹری	k uː ʈ r iː
کوٹھی	k uː ʈ ʰ iː
کوکب	k uː k b
کوہ	k uː h
کوہاٹ	k uː h a ʈ
کوہرا	k uː h r a
کوہلو	k uː h l uː
کویت	k uː j t
کویت	k uː j t
کویت	k uː j t
کٹھور	k ʈ ʰ uː r
کٹی	k ʈ iː
کپاس	k p a s
کپاسی	k p a s iː
کپتان	k p t a n
کپوت	k p uː t
کپڑا	k p ɽ a
کچا	k tʃ a
کچھ	k tʃ ʰ
کژدم	k ʒ d m
ککش	k k ʃ
کھاتا	k ʰ a t a
کھاتوں	k ʰ a t uː ŋ
کھاتے	k ʰ a t eː
کھاد	k ʰ a d
کھان	k ʰ a n
کھانا	k ʰ a n a
کھانگ	k ʰ a n ɡ
کھانگ	k ʰ a n ɡ
کھانی	k ʰ a n iː
کھاگ	k ʰ a ɡ
کھجلی	k ʰ dʒ l iː
کھجلی	k ʰ dʒ l iː
کھجور	k ʰ dʒ uː r
کھدیوت	k ʰ d iː ʋ t
کھر	k ʰ r
کھرجو	k ʰ r dʒ uː
کھرنا	k ʰ r n a
کھسرا	k ʰ s r a
کھلنا	k ʰ l n a
کھلنا	k ʰ l n a
کھلونا	k ʰ l uː n a
کھنن	k ʰ n n
کھنک	k ʰ n k
کھنکنا	k ʰ n k n a
کھوٹا	k ʰ uː ʈ a
کھٹا	k ʰ ʈ a
کھٹائی	k ʰ ʈ a ʔ iː
کھڈا	k ʰ ɖ a
کھڑا	k ʰ ɽ a
کھڑکی	k ʰ ɽ k iː
کھڑی	k ʰ ɽ iː
کھڑے	k ʰ ɽ eː
کھیت	k ʰ iː t
کھیرا	k ʰ iː r a
کھیل	k ʰ iː l
کھیلا	k ʰ iː l a
کھیلنا	k ʰ iː l n a
کھینچنا	k ʰ iː n tʃ n a
کھینچنا	k ʰ iː n tʃ n a
کھینچنا	k ʰ iː n tʃ n a
کہ	k h
کہ	k h
کہانی	k h a n iː
کہاوت	k h a ʋ t
کہاں	k h a ŋ
کہر	k h r
کہرا	k h r a
کہنا	k h n a
کہنی	k h n iː
کیا	k iː a
کیا	k iː a
کیتھولک	k iː t ʰ uː l k
کیرلا	k iː r l a
کیسے	k iː s eː
کیش	k iː ʃ
کیف	k iː f
کیل	k iː l
کیل	k iː l
کیلئے	k iː l ʔ eː
کیلا	k iː l a
کیلکولیٹر	k iː l k uː l iː ʈ r
کیلی	k iː l iː
کیلے	k iː l eː
کیمرہ	k iː m r h
کیمیا	k iː m iː a
کیمیائی	k iː m iː a ʔ iː
کینسر	k iː n s r
کینچلی	k iː n tʃ l iː
کینڈی	k iː n ɖ iː
کینیا	k iː n iː a
کینیڈا	k iː n iː ɖ a
کیوبیک	k iː ʋ b iː k
کیول	k iː ʋ l
کیچڑ	k iː tʃ ɽ
کیڑا	k iː ɽ a
کیک	k iː k
کیکر	k iː k r
کے	k eː
گ	ɡ
گ	ɡ
گاؤں	ɡ a ʔ ŋ
گاؤں	ɡ a ʔ ŋ
گائے	ɡ a ʔ eː
گاتر	ɡ a t r
گاجر	ɡ a dʒ r
گال	ɡ a l
گالی	ɡ a l iː
گام	ɡ a m
گان	ɡ a n
گانا	ɡ a n a
گانجا	ɡ a n dʒ a
گانو	ɡ a n uː
گانو	ɡ a n uː
گانو	ɡ a n uː
گانوں	ɡ a n uː ŋ
گانوں	ɡ a n uː ŋ
گانڈ	ɡ a n ɖ
گانڈو	ɡ a n ɖ uː
گانڈو	ɡ a n ɖ uː
گانے	ɡ a n eː
گاو	ɡ a ʋ
گاو	ɡ a ʋ
گاڑی	ɡ a ɽ iː
گایک	ɡ a j k
گتا	ɡ t a
گج	ɡ dʒ
گجرات	ɡ dʒ r a t
گدا	ɡ d a
گدگدانا	ɡ d ɡ d a n a
گدھ	ɡ d ʰ
گدھا	ɡ d ʰ a
گذارنا	ɡ z a r n a
گذراننا	ɡ z r a n n a
گذرنا	ɡ z r n a
گرام	ɡ r a m
گرانا	ɡ r a n a
گرج	ɡ r dʒ
گرجا	ɡ r dʒ a
گرجنا	ɡ r dʒ n a
گردن	ɡ r d n
گرز	ɡ r z
گرم	ɡ r m
گرم	ɡ r m
گرما	ɡ r m a
گرمکھی	ɡ r m k ʰ iː
گرمیاں	ɡ r m iː a ŋ
گرنا	ɡ r n a
گرنتھ	ɡ r n t ʰ
گرو	ɡ r uː
گروہ	ɡ r uː h
گرڈ	ɡ r ɖ
گرہن	ɡ r h n
گزارش	ɡ z a r ʃ
گزارہ	ɡ z a r h
گفتار	ɡ f t a r
گفتگو	ɡ f t ɡ uː
گلاب	ɡ l a b
گلابی	ɡ l a b iː
گلاس	ɡ l a s
گلال	ɡ l a l
گلانی	ɡ l a n iː
گلشن	ɡ l ʃ n
گلو	ɡ l uː
گلو	ɡ l uː
گلو	ɡ l uː
گلگت	ɡ l ɡ t
گلہری	ɡ l h r iː
گلی	ɡ l iː
گلیل	ɡ l iː l
گلیم	ɡ l iː m
گم	ɡ m
گمان	ɡ m a n
گمانا	ɡ m a n a
گمبھیر	ɡ m b ʰ iː r
گمنام	ɡ m n a m
گناہ	ɡ n a h
گنبد	ɡ n b d
گنبذ	ɡ n b z
گنبھیر	ɡ n b ʰ iː r
گنت	ɡ n t
گنتی	ɡ n t iː
گنجا	ɡ n dʒ a
گندمی	ɡ n d m iː
گندگی	ɡ n d ɡ iː
گندھک	ɡ n d ʰ k
گندہ	ɡ n d h
گنی	ɡ n iː
گنیش	ɡ n iː ʃ
گوا	ɡ uː a
گوادر	ɡ uː a d r
گوادر	ɡ uː a d r
گوبھی	ɡ uː b ʰ iː
گوجرانوالہ	ɡ uː dʒ r a n uː a l h
گوجرہ	ɡ uː dʒ r h
گورا	ɡ uː r a
گورداسپور	ɡ uː r d a s p uː r
گورستان	ɡ uː r s t a n
گورمنٹ	ɡ uː r m n ʈ
گورو	ɡ uː r uː
گوزن	ɡ uː z n
گوزن	ɡ uː z n
گوزن	ɡ uː z n
گوشت	ɡ uː ʃ t
گول	ɡ uː l
گولی	ɡ uː l iː
گوٹھ	ɡ uː ʈ ʰ
گوپن	ɡ uː p n
گوگرد	ɡ uː ɡ r d
گٹار	ɡ ʈ a r
گٹھری	ɡ ʈ ʰ r iː
گپ	ɡ p
گڈا	ɡ ɖ a
گڑ	ɡ ɽ
گڑھ	ɡ ɽ ʰ
گڑیا	ɡ ɽ iː a
گگن	ɡ ɡ n
گھاس	ɡ ʰ a s
گھاو	ɡ ʰ a ʋ
گھاٹا	ɡ ʰ a ʈ a
گھاٹا	ɡ ʰ a ʈ a
گھبرانا	ɡ ʰ b r a n a
گھر	ɡ ʰ r
گھرانا	ɡ ʰ r a n a
گھرنا	ɡ ʰ r n a
گھریلو	ɡ ʰ r iː l uː
گھمنڈ	ɡ ʰ m n ɖ
گھنٹا	ɡ ʰ n ʈ a
گھنٹہ	ɡ ʰ n ʈ h
گھنٹی	ɡ ʰ n ʈ iː
گھوش	ɡ ʰ uː ʃ
گھونسلہ	ɡ ʰ uː n s l h
گھونٹ	ɡ ʰ uː n ʈ
گھونٹ	ɡ ʰ uː n ʈ
گھوٹکی	ɡ ʰ uː ʈ k iː
گھوڑا	ɡ ʰ uː ɽ a
گھٹنا	ɡ ʰ ʈ n a
گھٹنا	ɡ ʰ ʈ n a
گھڑی	ɡ ʰ ɽ iː
گھڑیال	ɡ ʰ ɽ iː a l
گھی	ɡ ʰ iː
گہرا	ɡ h r a
گیا	ɡ iː a
گیت	ɡ iː t
گیر	ɡ iː r
گیزر	ɡ iː z r
گیس	ɡ iː s
گیسن	ɡ iː s n
گیلا	ɡ iː l a
گیند	ɡ iː n d
گینڈا	ɡ iː n ɖ a
گینڈا	ɡ iː n ɖ a
گیہوں	ɡ iː h uː ŋ
گے	ɡ eː
ں	ŋ
ھ	ʰ
ھ	ʰ
ہ	h
ہ	h
ہاتھ	h a t ʰ
ہاتھی	h a t ʰ iː
ہار	h a r
ہارون	h a r uː n
ہانک	h a n k
ہانکنا	h a n k n a
ہاں	h a ŋ
ہتھیار	h t ʰ iː a r
ہتھیلی	h t ʰ iː l iː
ہتیارا	h t iː a r a
ہجوم	h dʒ uː m
ہجے	h dʒ eː
ہدایت	h d a j t
ہرانا	h r a n a
ہرن	h r n
ہرنائی	h r n a ʔ iː
ہریانہ	h r iː a n h
ہسپانی	h s p a n iː
ہسپانیہ	h s p a n iː h
ہفتو	h f t uː
ہفتوں	h f t uː ŋ
ہفتہ	h f t h
ہفتے	h f t eː
ہفوۃ	h f uː
ہل	h l
ہلسہ	h l s h
ہلو	h l uː
ہلکا	h l k a
ہلکان	h l k a n
ہم	h m
ہمارا	h m a r a
ہمالیہ	h m a l iː h
ہماہمی	h m a h m iː
ہمایوں	h m a j ʋ ŋ
ہمت	h m t
ہمجنسیت	h m dʒ n s iː t
ہمسفر	h m s f r
ہمیشگی	h m iː ʃ ɡ iː
ہمیشہ	h m iː ʃ h
ہمیں	h m iː ŋ
ہند	h n d
ہندو	h n d uː
ہندوتوا	h n d uː t uː a
ہندوتوا	h n d uː t uː a
ہندوستان	h n d uː s t a n
ہندوستان	h n d uː s t a n
ہندوستانی	h n d uː s t a n iː
ہندوستانی	h n d uː s t a n iː
ہندوی	h n d uː j
ہندی	h n d iː
ہندیہ	h n d iː h
ہنزلو	h n z l uː
ہنسا	h n s a
ہنساتمک	h n s a t m k
ہنسلو	h n s l uː
ہنسنا	h n s n a
ہنسنا	h n s n a
ہنسنا	h n s n a
ہنڈی	h n ɖ iː
ہنگامی	h n ɡ a m iː
ہوا	h uː a
ہوا	h uː a
ہوائی	h uː a ʔ iː
ہوتا	h uː t a
ہود	h uː d
ہوس	h uː s
ہوسیع	h uː s iː ʔ
ہوشنگ	h uː ʃ n ɡ
ہوشیار	h uː ʃ iː a r
ہوشیع	h uː ʃ iː ʔ
ہولی	h uː l iː
ہونا	h uː n a
ہونٹ	h uː n ʈ
ہونٹ	h uː n ʈ
ہونٹھ	h uː n ʈ ʰ
ہوٹل	h uː ʈ l
ہوں	h uː ŋ
ہچکنا	h tʃ k n a
ہچکی	h tʃ k iː
ہڈی	h ɖ iː
ہکا	h k a
ہیجڑا	h iː dʒ ɽ a
ہیر	h iː r
ہیرا	h iː r a
ہیضہ	h iː z h
ہیمبرگ	h iː m b r ɡ
ہیمبرگ	h iː m b r ɡ
ہیک	h iː k
ہیں	h iː ŋ
ہے	h eː
ہے	h eː
ہے	h eː
ہے	h eː
ی	j
ی	j
ی	j
ی	j
یا	j a
یات	j a t
یاد	j a d
یار	j a r
یاسمین	j a s m iː n
یال	j a l
یاور	j a ʋ r
یت	j t
یت	j t
یتیم	j t iː m
یحیی	j h iː j
یخ	j x
یدھ	j d ʰ
یدھ	j d ʰ
یرغمال	j r ɣ m a l
یرمیاہ	j r m iː a h
یروشلم	j r uː ʃ l m
یروشلم	j r uː ʃ l m
یروشلم	j r uː ʃ l m
یزدان	j z d a n
یزیدیت	j z iː d iː t
یسعیاہ	j s ʔ iː a h
یسوع	j s uː ʔ
یعقوب	j ʔ q uː b
یعنی	j ʔ n iː
یقین	j q iː n
یقینا	j q iː n a
یمن	j m n
یمنا	j m n a
ین	j n
یوحنا	j ʋ h n a
یورش	j ʋ r ʃ
یوروپ	j ʋ r uː p
یورپ	j ʋ r p
یوسف	j ʋ s f
یوغ	j ʋ ɣ
یوغ	j ʋ ɣ
یوم	j ʋ m
یون	j ʋ n
یونان	j ʋ n a n
یونانی	j ʋ n a n iː
یونس	j ʋ n s
یوکرین	j ʋ k r iː n
یوگدان	j ʋ ɡ d a n
یوگنڈا	j ʋ ɡ n ɖ a
یوگیتو	j ʋ ɡ iː t uː
یوگیہ	j ʋ ɡ iː h
یوں	j ʋ ŋ
یوں	j ʋ ŋ
یک	j k
یکتا	j k t a
یکم	j k m
یکیدم	j k iː d m
یگانہ	j ɡ a n h
یہ	j h
یہاں	j h a ŋ
یہود	j h uː d
یہودنی	j h uː d n iː
یہودنی	j h uː d n iː
یہودی	j h uː d iː
یہودیت	j h uː d iː t
یہودیت	j h uː d iː t
یہودیہ	j h uː d iː h
ے	eː
ے	eː
