ء	y ih
ء	g aa ow
ء	g aa unk ow
ء	h ah m z aa
ء	unk
آئرلینڈ	aa ih unk l eh n dx
آئی	aa iy
آئین	aa iy n
آئینہ	aa iy n aa
آب	aa b
آباد	aa b aa d
آبادانی	aa b aa d aa n iy
آبادی	aa b aa d iy
آبدوز	aa b d ow z
آبشار	aa b sh aa unk
آبنائے	aa b n aa ey
آبچین	aa b ch iy n
آبی	aa b iy
آتش	aa t ih sh
آتما	aa t m aa
آتنکوادی	aa t ah ng k v aa d iy
آج	aa jh
آخرت	aa unk ih unk ah t
آخری	aa unk unk iy
آخن	aa unk ah n
آخور	aa unk ow unk
آداب	aa d aa b
آدر	aa d ah unk
آدم	aa d ah m
آدمی	aa d m iy
آدھا	aa dh aa
آدھنک	aa dh uh n ih k
آذر	aa z ah unk
آذربائیجان	aa z ah unk b aa ih jh aa n
آرام	aa unk aa m
آربل	aa unk b ah l
آرزو	aa unk z uw
آرمبھ	aa unk ah m bh
آرمی	aa unk m iy
آرمینیا	aa unk m ey n ih y aa
آرمینیا	aa unk m iy n ih y aa
آروپ	aa unk ow p
آروگیہ	aa unk ow g y aa
آریامن	aa unk y ah m ah n
آریہ	aa unk y
آرے	aa unk ey
آزاد	aa z aa d
آزادی	aa z aa d iy
آزمائش	aa z m aa ih sh
آزمانا	aa z m aa n aa
آزمودگی	aa z m uw d ah g iy
آزمودہ	aa z m uw d aa
آس	aa s
آسام	aa s aa m
آسامی	aa s aa m iy
آسان	aa s aa n
آسان	ah s aa n
آسانی	aa s aa n iy
آستھا	aa s th aa
آستین	aa s t iy n
آسرا	aa s unk aa
آسمان	aa s m aa n
آسمانی	aa s m aa n iy
آسن	aa s ah n
آسند	aa s ah n d
آسٹریا	aa s tx unk ih y aa
آسٹریلیا	aa s tx unk ey l ih y aa
آسکت	aa s ah k t
آسکول	aa s k ow l
آسیب	aa s ey b
آشچریہ	aa sh ch ah unk y
آشیرواد	aa sh iy unk v aa d
آغا	aa gq aa
آغاز	aa gq aa z
آغوش	aa gq ow sh
آفت	aa f ah t
آفتاب	aa f t aa b
آفتابی	aa f t aa b iy
آفریدی	aa f unk iy d iy
آفرین	aa f unk iy n
آقا	aa q aa
آقچہ	aa q ch aa
آلس	aa l ah s
آلسی	aa l s iy
آلنگن	aa l ih ng g ah n
آلو	aa l uw
آلود	aa l uw d
آلودگی	aa l uw d ah g iy
آلودہ	aa l uw d aa
آلوچنا	aa l ow ch n aa
آلچی	aa l ch iy
آلہ	aa l aa
آم	aa m
آمر	aa m ih unk
آمریت	aa m ih unk ih y ah t
آمنہ	aa m ih n aa
آموختہ	aa m ow unk t aa
آمود	aa m ow d
آموزش	aa m ow z ih sh
آمیزش	aa m ey z ih sh
آنا	aa n aa
آندھی	aa n dh iy
آنسو	aa n s uw
آنسو	aa s uw
آنکھ	aa kh
آنکھ	aa kh
آنکھو	aa ng kh ow
آنکھوں	aa kh ow
آنکھیں	aa ng kh eh
آنگن	aa ng g ah n
آواران	aa v aa unk aa n
آوارہ	aa v aa unk aa
آواز	aa v aa z
آوشيکتا	aa v ah sh y ah k t aa
آٹا	aa tx aa
آٹھ	aa txh
آٹھواں	aa txh w aa
آٹھواں	aa txh v aa
آپ	aa p
آپا	aa p aa
آپی	aa p iy
آچار	aa ch aa unk
آڑو	aa r uw
آکاش	aa k aa sh
آکاشی	aa k aa sh iy
آکرشت	aa k ah unk sh ih t
آکرمن	aa k unk ah m ah n
آکھیٹ	aa kh ey tx
آگ	aa g
آگار	aa g aa unk
آگرہ	aa g unk ah h
آگھات	aa g aa t
آگے	aa g ey
آہ	aa h
آہستہ	aa h ih s t aa
آہو	aa h uw
آیا	aa y aa
آیت	aa y ah t
ا	aa
ا	ah
ا	ah l ih f
ا	unk
ابابیل	ah b aa b iy l
اباضی	ih b aa z iy
ابال	uh b aa l
ابالنا	uh b aa l n aa
ابتدا	ih b t ih d aa
ابتدائی	ih b t ih d aa iy
ابتسام	ih b t ih s aa m
ابدا	ah b d ah n
ابراہیم	ih b unk aa h iy m
ابرق	ah b unk ah q
ابرنجن	ah b unk ah n jh ah n
ابرنجین	ah b unk ah n jh iy n
ابریق	ih b unk iy q
ابلق	ah b l ah q
ابلنا	uh b ah l n aa
ابلیس	ih b l iy s
ابلیسیانہ	ih b l iy s ih y aa n aa
ابن	ih b n
ابنہ	ih b n aa
ابو	ah b uw
ابٹن	uh b tx ah n
ابکائی	uh b k aa iy
ابھار	uh bh aa unk
ابھاو	ah bh aa v
ابھرتا	uh bh ah unk t aa
ابھشیک	ah bh ih sh ey k
ابھمان	ah bh ih m aa n
ابھی	ah bh iy
ابھی	ah bh ah y
ابہام	ih b h aa m
اتارنا	uh t aa unk n aa
اتاق	uw t aa q
اتالیق	ah t aa l iy q
اتحاد	ih t eh h aa d
اتحاد	ih t ih h aa d
اتحادی	ih t t ih h aa d iy
اترنا	uh t ah unk n aa
اتصال	ih t t ih s aa l
اتفاق	ih t t ih f aa q
اتفاقا	ih t t ih f aa q ah n
اتم	ah t ah m
اتمام	ih t m aa m
اتمک	ah t m ah k
اتوار	ih t v aa unk
اتھان	uh t th aa n
اتہاس	ih t ih h aa s
اتہام	ih t t ih h aa m
اتیاچاری	ah t y aa ch aa unk iy
اثاث	ah s aa s
اثبات	ih s b aa t
اثر	ah s ah unk
اثنا	ah s n aa
اجازت	ih jh aa z ah t
اجالا	uh jh aa l aa
اجالنا	uh jh aa l n aa
اجتماع	ih jh t ih m aa
اجر	ah jh unk
اجرا	ih jh unk aa
اجرت	uh jh unk ah t
اجزا	ah jh z aa
اجل	ah jh ah l
اجلاس	ih jh l aa s
اجمالی	ih jh m aa l iy
اجنبی	ah jh n ah b iy
اجوائن	ah jh v aa ih n
اجگر	ah jh g ah unk
اجی	ah jh iy
احباب	ah h b aa b
احتجاج	ey h t ih jh aa jh
احترام	eh h t eh unk aa m
احترام	eh h t ih unk aa m
احتمال	ey h t ey m aa l
احتیاج	ih h t ih y aa jh
احساس	eh h s aa s
احسان	ah h ah s aa n
احشا	ah h sh aa
احمد	ah h m ah d
احمق	ah h m ah q
احوال	ah h v aa l
احیا	ah h y aa
احیا	ih h y aa
اخاہ	ah kh aa h
اخبار	ah unk b aa unk
اختلاف	ih unk t ih l aa f
اختہ	ah unk t aa
اختیار	ih unk t ih y aa unk
اختیاری	ih unk t ih y aa unk iy
اخذ	ah unk z
اخروٹ	ah unk unk ow tx
اخلاط	ah unk l aa t
اخلاق	ah unk l aa q
اخلاق	ih unk l aa q
ادا	ah d aa
ادائیگی	ah d aa iy g iy
ادارتی	ih d aa unk ah t iy
ادارہ	ih d aa unk aa
اداری	ih d aa unk iy
اداس	uh d aa s
اداسی	uh d aa s iy
اداہرن	uh d aa h unk ah n
ادب	ah d ah b
ادبا	uh d ah b aa
ادبی	ah d ah b iy
ادبیات	ah d ah b ih y y aa t
ادرنہ	ah d ih unk n aa
ادرک	ah d unk ah k
ادریس	ih d unk iy s
اديان	ah d y aa n
ادھار	uh dh aa unk
ادھلنا	uh dh ah l n aa
ادھماس	ah dh ih m aa s
ادھورا	ah dh uw unk aa
ادھکار	ah dh ih k aa unk
ادھکاری	ah dh ih k aa unk iy
ادھیڑ	ah dh ey r
ادہم	ah d h ah m
ادیب	ah d iy b
ادیہ	ah d y
اذن	ih z n
اذیت	ah z ih y ah t
ارب	ah unk ah b
ارتعاش	ih unk t ih aa sh
ارتھ	ah unk th
ارجت	ah unk jh ih t
ارجن	ah unk jh ah n
ارجن	ah unk jh uh n
ارجنٹائن	ah unk jh ah n tx aa ih n
اردلی	ah unk d ah l iy
اردن	uh unk d uh n
اردو	uh unk d uw
ارز	ah unk z
ارسطو	ah unk ah s t uw
ارش	ah unk sh
ارض	ah unk z
ارغوانی	ah unk gq v aa n iy
ارمان	ah unk m aa n
ارمنستان	ah unk m ah n ih s t aa n
ارمیا	ih unk m ih y aa
ارے	ah unk ey
از	ah z
ازبک	uh z b ah k
ازبکستان	uh z b ah k ih s t aa n
ازدواج	ih z d ih v aa jh
اساس	ah s aa s
اساس	uh s aa s
اساسی	ah s aa s iy
اسباب	ah s b aa b
استاد	uh s t aa d
استبداد	ih s t ih b d aa d
استخلاف	ih s t ih unk l aa f
استخوان	uh s t uh unk w aa n
استر	ah s t ah unk
استری	ih s t ah unk iy
استری	ih s t ih unk iy
استری	ih s t unk iy
استعفی	ih s t iy f aa
استعمال	ih s t ey m aa l
استقبال	ih s t ih q b aa l
استنبول	ih s t ah m b ow l
استوار	uh s t ah w aa unk
استوار	uh s t uh v aa unk
استور	ah s t ow unk
استھ	ah s th iy
اسحاق	ih s h aa q
اسرائیل	ih s unk aa iy l
اسراف	ih s unk aa f
اسلام	ih s l aa m
اسلامی	ih s l aa m iy
اسلحہ	ah s l ah h aa
اسلحہ	ah s l ih h aa
اسلوب	uh s l uw b
اسم	ah s ah m
اسم	ih s m
اسماعیل	ih s m aa unk iy l
اسٹیشن	ih s tx ey sh ah n
اسٹیڈیم	ih s tx ey dx ih y ah m
اسپ	ah s p
اسپات	ih s p aa t
اسپتال	ah s p ah t aa l
اسپغول	ih s p ah gq ow l
اسکول	ih s k uw l
اسہال	ih s h aa l
اسیر	ah s iy unk
اسیری	ah s iy unk iy
اشارہ	ih sh aa unk aa
اشاعت	ih sh aa t
اشاعت	ih sh aa unk ah t
اشبھ	ah sh uh bh
اشبیلیہ	ah sh b iy l ih y aa h
اشتباہا	ih sh t ih b aa h ah n
اشتراک	ih sh t ih unk aa k
اشتراکیت	ih sh t ih unk aa k ih y ah t
اشتقاق	ih sh t ih q aa q
اشتہا	ih sh t ih h aa
اشتہار	ih sh t ih h aa unk
اشراق	ih sh unk aa q
اشوک	ah sh ow k
اشک	ah sh k
اصطبل	ah s t ah b ah l
اصطلاح	ih s t ih l aa h
اصغر	ah s gq ah unk
اصل	ah s ah l
اصلاح	ih s l aa h
اصول	uh s uw l
اصہار	ah s h aa unk
اصیل	ah s iy l
اضافہ	ih z aa f aa
اضطراری	ih z t ih unk aa unk iy
اطالیہ	ih t aa l ih y aa
اطفال	ah t f aa l
اطلاع	ih t t ih l aa unk
اطلاقی	ih t l aa q iy
اطلس	ah t l ah s
اطمینان	ih t m iy n aa n
اعتبار	ih ai t ih b aa unk
اعتراف	ey unk t ih unk aa f
اعتماد	ih unk t ih m aa d
اعضا	aa z aa
اعضا	ah unk z aa
اعظم	aa unk z ah m
اعلی	aa unk l aa
اغوا	ah gq v aa
اغوا	ih gq v aa
افراد	ah f unk aa d
افریقہ	ah f unk iy q aa
افزائش	ah f z aa ih sh
افسانہ	ah f s aa n aa
افطار	ih f t aa unk
افطاری	ih f t aa unk iy
افغان	ah f gq aa n
افغانستان	ah f gq aa n ih s t aa n
افق	uh f uh q
افلاس	ih f l aa s
اقامت	ih q aa m ah t
اقتدار	ih q t ih d aa unk
اقتصادی	ih q t ih s aa d iy
اقلیت	ah q l ih y ah t
اقلیت	ah q ah l l ih y ah t
اقلیم	ih q l iy m
الائچی	ih l aa y ch iy
البانیا	ah l b aa n ih y aa
البتہ	ah l b ah t t aa
الجزائر	ah l jh ah z aa y ih unk
الحاق	ih l h aa q
الزام	ih l z aa m
اللہ	ah l l aa
اللہ	ah l l aa h
الم	ah l ah m
الماری	ah l m aa unk iy
الماس	ah l m aa s
النکار	ah l ah ng k aa unk
النکرت	ah l ah ng k unk ih t
الوداع	ah l v ih d aa
الوداع	ah l v ih d ah unk
الٹی	uh l tx iy
الکحل	ah l k uh h uh l
الگ	ah l ah g
الہام	ih l h aa m
الیاس	ih l y aa s
الیسع	ah l y ah s ah unk
امارت	ih m aa unk ah t
امام	ih m aa m
امانت	ah m aa n ah t
امتحان	ih m t ih h aa n
امداد	ih m d aa d
امر	ah m unk
امرا	uh m ah unk aa
امرتسر	ah m unk ih t s ah unk
امرود	ah m unk uw d
امروز	ih m unk ow z
امریکا	ah m unk iy k aa
امریکہ	ah m unk iy k aa
امل	ah m ah l
املا	ih m l aa
امن	ah m ah n
امور	uh m uw unk
امکان	ih m k aa n
امی	ah m iy
امید	uh m m ey d
امید	uh m m iy d
امیدوار	uh m m ey d v aa unk
امیدوار	uh m m iy d v aa unk
امیر	ah m iy unk
امینہ	ah m iy n aa
اناتھ	ah n aa th
انار	ah n aa unk
انارکلی	ah n aa unk k ah l iy
انبار	ah m b aa unk
انبیاء	ah m b ih y aa
انت	ah n t
انتباہ	ih n t ih b aa h
انتخاب	ih n t ey unk aa b
انتخاب	ih n t ih unk aa b
انتر	ah n t ah unk
انترم	ah n t unk ih m
انتظار	ih n t eh z aa unk
انتظار	ih n t ah z aa unk
انتظار	ih n t ih z aa unk
انتظام	ih n t ih z aa m
انتظامی	ih n t ih z aa m iy
انتظامیہ	ih n t ih z aa m ih y aa
انتقال	ih n t ih q aa l
انتم	ah n t ih m
انتہائی	ih n t ih h aa iy
انتہاپسند	ih n t eh h aa p ah s ah n d
انجام	ah n jh aa m
انجانا	ah n jh aa n aa
انجیر	ah n jh iy unk
انداز	ah n d aa z
اندراج	ih n d ih unk aa jh
اندلس	uh n d uh l uh s
اندھا	ah n dh aa
اندھکار	ah n dh k aa unk
اندھیرا	ah n dh ey unk aa
اندیکھا	ah n d ey kh aa
انسان	ih n s aa n
انسانی	ih n s aa n iy
انش	ah n sh
انصاف	ih n s aa f
انطاکیہ	ah n t aa k ih y aa
انطلیاس	ah n t ih l y aa s
انعام	ih n unk aa m
انقلاب	ih n q ah l aa b
انقلاب	ih n q ih l aa b
انوادک	ah n uh v aa d ah k
انوکھا	ah n ow kh aa
انٹارکٹکا	ah n tx aa unk k tx ih k aa
انپم	ah n uh p ah m
انچل	ah n ch ah l
انڈا	ah n dx aa
انڈونیشیا	ih n dx ow n ey sh ih y aa
انڈکوش	ah n dx ah k ow sh
انڈیا	ih n dx ih y aa
انکار	ih n k aa unk
انکل	ah ng k ah l
انگریز	ah ng g unk ey z
انگریزی	ax ng g unk ey z iy
انگلستان	ih ng g l ih s t aa n
انگلی	uh ng g l iy
انگلینڈ	ih ng g l eh n dx
انگور	ah n g uw unk
انگوری	ah ng g uw unk iy
انگولہ	ah ng g ow l aa
انگوٹھا	ah ng g uw txh aa
انگوٹھی	ah ng g uw txh iy
انگھیٹی	ah ng g iy tx iy
انھیں	ih n eh
انھیں	uh n eh
انہ	aa n aa
انہیں	ih n h eh
انہیں	uh n h eh
انیک	ah n ey k
اوتھل	uw th aa l
اودا	uw d aa
اودبلاؤ	uw d b ih l aa ow
اودھی	ah v ah dh iy
اور	ao unk
اورماڑا	ow unk m aa r aa
اورنگ	ao unk ah n g
اورنگزیب	ao unk ah ng g z ey b
اوس	ow s
اوساکا	ow s aa k aa
اوسطا	ao s t ah n
اوقات	ao q aa t
اول	ah v ah l
اولا	ow l aa
اولاد	ao l aa d
اولو	uh l uw
اولی	uw l aa
اولی	ao l aa
اولی	uh l iy
اونٹ	uw tx
اونچائی	uw ch aa iy
اونگھ	uw ng g
اوپر	uw p ah unk
اوڈیشہ	ow dx iy sh ah h
اوڑی	uw r iy
اوکاش	ah v k aa sh
اوکاڑہ	ow k aa r aa
اوکھی	ao kh iy
اوہ	uw h
اویغور	uw ih gq uw unk
اویغورستان	uw ih gq uw unk ih s t aa n
اٹاری	ah tx aa unk iy
اٹاچی	ah tx aa ch iy
اٹاچی	ah tx eh ch iy
اٹک	ah tx ah k
اٹھانا	uh txh aa n aa
اپاسک	uh p aa s ah k
اپاہج	ah p aa h ih jh
اپبھوگ	uh p bh ow g
اپدهان	uh p dh aa n
اپدیش	uh p d ey sh
اپرادھ	ah p unk aa dh
اپرادھی	ah p unk aa dh iy
اپرمپار	ah p unk ah m p aa unk
اپریل	ah p unk eh l
اپستھت	uh p ah s th ih t
اپلبدھ	uh p l ah b dh
اپنا	ah p n aa
اپنيتر	uh p n ey t r
اپہار	uh ph aa unk
اپیوگ	uh p y ow g
اچار	ah ch aa unk
اچانک	ah ch aa n ah k
اچت	uh ch ih t
اچکیریہ	ih ch k ey unk y aa
اچکیریہ	ih ch k iy unk y aa
اچھا	ah t ch aa
اچھا	ih t ch aa
اچھلنا	uh ch ah l n aa
اڑان	uh r aa n
اڑانا	uh r aa n aa
اڑنا	ah r n aa
اڑنا	uh r n aa
اژدہا	ah zh d ah h aa
اک	ih k
اکادمک	ah k aa d m ih k
اکادمی	ah k aa d ah m iy
اکال	ah k aa l
اکانوے	ih k aa n v ey
اکتوبر	ah k t uw b ah unk
اکثر	ah k s ah unk
اکلوتا	ih k l ao t aa
اکنون	ah k n uw n
اکھروٹ	ah kh unk ow tx
اکیلا	ah k ey l aa
اکیلاپن	ah k ey l aa p ah n
اکیلے	ah k ey l ey
اگر	ah g ah unk
اگربتی	ah g ah unk b ah t t iy
اگرچہ	ah g ah unk ch ey
اگست	ah g ah s t
اگلا	ah g l aa
اگنا	uh g n aa
اگنی	ah g n iy
ایالت	ih y aa l ah t
ایت	ah y uh t
ایتھنز	ey th ah n z
ایتھنز	iy th ah n z
ایتھوپیا	ih th ih y ow p ih y aa
ایجنٹ	ey jh ah n tx
ایران	iy unk aa n
ایرانی	iy unk aa n iy
ایزد	ey z ah d
ایزد	ey z ih d
ایزد	iy z ah d
ایزد	iy z ih d
ایشور	iy sh v ah unk
ایلچی	ey l ch iy
ایمان	iy m aa n
ایماندار	iy m aa n d aa unk
اینٹ	iy tx
ایواللہ	ey v ah l l aa h
ایوان	eh v aa n
ایوب	ah y y uw b
ایڈنبرا	iy dx ih m b unk aa
ایڈنبرا	iy dx ih n b unk aa
ایڈنبرا	eh dx ih n b unk aa
ایک	ey k
ب	b
ب	b ey
بائبل	b aa ih b ih l
بائیسکل	b aa iy s ih k ah l
بابو	b aa b uw
بات	b aa t
باتھروم	b aa th unk uw m
باجی	b aa jh iy
باختر	b aa unk t ah unk
باد	b aa d
بادام	b aa d aa m
بادام	b ah d aa m
بادامی	b aa d aa m iy
بادشاہ	b aa d sh aa h
بادشاہت	b aa d sh aa h ah t
بادل	b aa d ah l
بار	b aa unk
بارات	b aa unk aa t
باراں	b aa unk aa
بارش	b aa unk ih sh
بارکھان	b aa unk kh aa n
بارہا	b aa unk h aa
باریک	b aa unk iy k
بازار	b aa z aa unk
بازار	b ah z aa unk
بازو	b aa z uw
بازی	b aa z iy
باشندہ	b aa sh ih n d aa
باعث	b aa unk ih s
باغ	b aa gq
باغی	b aa gq iy
باغیچہ	b aa gq iy ch aa
باقی	b aa q iy
بال	b aa l
بالش	b aa l ih sh
بالفعل	b ih l f ih ai l
بالکل	b ih l k uh l
باندھنا	b aa n dh n aa
بانس	b aa n s
بانسو	b aa n s ow
بانسوں	b aa n s ow
بانو	b aa n ow
بانو	b aa n uw
بانچنا	b aa ch n aa
بانہو	b aa h ow
بانہوں	b aa h ow
بانہہ	b aa h
بانہیں	b aa h eh
باورچی	b aa v ah unk ch iy
باٹ	b aa tx
باڑھ	b aa r
باکو	b aa k uw
باہر	b aa h ah unk
باہر	b aa h ih unk
باہم	b aa h ah m
باہمی	b aa h ah m iy
باہوبلی	b aa h uh b ah l iy
ببھکشا	b uh bh uh k sh aa
بت	b uh t
بتانا	b ah t aa n aa
بتانا	b ih t aa n aa
بجائے	b ah jh aa ey
بجری	b ah jh unk iy
بجلی	b ih jh l iy
بجے	b ah jh ey
بحال	b ah h aa l
بحر	b ah h unk
بحران	b ow h unk aa n
بحرین	b ah h unk iy n
بحریہ	b ah h unk ih y aa
بخش	b ah unk sh
بدبو	b ah d b ow
بدبو	b ah d b uw
بددعا	b ah d d uh aa
بدر	b ah d ah unk
بدصورت	b ah d s uw unk ah t
بدعنوانی	b ah d unk uh n v aa n iy
بدلنا	b ah d ah l n aa
بدلوانا	b ah d ah l v aa n aa
بدلہ	b ah d l aa
بدن	b ah d ah n
بدنصیب	b ah d n ah s iy b
بدنیت	b ah d n iy t
بدولت	b ah d ao l ah t
بدھ	b uh dh
بدھرتا	b ah dh ih unk t aa
بدھوار	b uh dh v aa unk
بدھیا	b ah dh ih y aa
بدیع	b ah d iy
بدیع	b ah d iy unk
بدین	b ah d iy n
برآمد	b ah unk aa m ah d
برا	b uh unk aa
برات	b ah unk aa t
برازیل	b unk aa z iy l
برباد	b ah unk b aa d
برتن	b ah unk t ah n
برج	b uh unk jh
برس	b ah unk ah s
برسات	b ah unk s aa t
برسلز	b unk ah s ah l z
برسی	b ah unk s iy
برصغیر	b ah r eh s ah gq iy unk
برف	b ah unk f
برق	b ah unk q
برقع	b uh unk q aa
برقی	b ah unk q iy
برلن	b ah unk l ih n
برما	b ah unk m aa
برمنگھم	b ah unk m ih ng g ah m
بروخے	b unk uw unk ey
برودت	b uh unk uw d ah t
برچھا	b ah unk ch aa
برچھیت	b ah unk ch eh t
برکت	b ah unk k ah t
برکها	b ah unk kh aa
برگزیدہ	b ah unk g uh z iy d aa
برہنہ	b ah unk ah h n aa
برہنہ	b ih unk ah h n aa
بریشال	b ah unk iy s h aa l
بزار	b ah z aa unk
بزرگ	b uh z uh unk g
بزرگی	b uh z ah unk g iy
بس	b ah s
بستر	b ih s t ah unk
بستی	b ah s t iy
بسکٹ	b ih s k ih tx
بسیار	b ih s y aa unk
بشیر	b ah sh iy unk
بطخ	b ah t ah unk
بظاہر	b ah z aa h ih unk
بعث	b ah unk s
بعد	b aa d
بعلبک	b ah unk l ah b ah k
بغاوت	b ah gq aa v ah t
بغل	b ah gq ah l
بغیر	b ah gq eh unk
بغیچہ	b ah gq iy ch aa
بقار	b ah q q aa unk
بقر	b ah q ah unk
بقرعید	b ah q ah unk unk iy d
بقرعید	b ah q unk iy d
بقرہ	b ah q ah unk aa
بلا	b ah l l aa
بلا	b ah l aa
بلا	b ih l l aa
بلا	b uh l l aa
بلب	b ah l b
بلغاری	b uh l gq aa unk iy
بلغاریہ	b uh l gq aa unk ih y aa
بلغم	b ah l gq ah m
بلند	b uh l ah n d
بلوغت	b uh l uw gq ah t
بلوچستان	b ah l ow ch ih s t aa n
بلکہ	b ah l k iy
بلہار	b ah l ih h aa unk
بلی	b ih l l iy
بلیدہ	b uh l eh d aa
بم	b ah m
بمباری	b ah m b aa unk iy
بمبہ	b ah m b
بمقابلہ	b unk m uh q aa b l aa
بمقابلہ	b unk m uh q aa b ih l aa
بمقابلہ	b ah m uh q aa b ih l aa
بنا	b ah n n aa
بنا	b ih n aa
بنارس	b ah n aa unk ah s
بنانا	b ah n aa n aa
بناوٹ	b ah n aa v ah t
بناوٹی	b ah n aa v ah tx iy
بنت	b ih n t
بنتی	b ih n t iy
بنجارا	b ah n jh aa unk aa
بنجی	b uh n jh iy
بند	b ah n d
بندر	b ah n d ah unk
بندوق	b ah n d uw k
بندوق	b ah n d uw q
بندھن	b ah n dh ah n
بندہ	b ah n d aa
بنزین	b ah n z iy n
بنفشی	b ah n ah f sh iy
بنيان	b ah n ih y aa n
بنگ	b ah ng g
بنگال	b ah ng g aa l
بنگالی	b ah n g aa l iy
بنیادی	b uh n ih y aa d iy
بو	b ow
بو	b uw
بواب	b ah v v aa b
بوتل	b ow t ah l
بوجھ	b ow jh
بودار	b uw d aa unk
بور	b ow unk
بوریت	b ow unk ih y ah t
بوسنیا	b ow s n ih y aa
بوسہ	b ow s aa
بولنا	b ow l n aa
بولی	b ow l iy
بوم	b uw m
بونا	b ow n aa
بونا	b ao n aa
بونڈر	b ah v ah n dx ah unk
بوٹ	b uw tx
بوچڑ	b uw ch ah r
بوڑھا	b uw r aa
بٹن	b ah tx ah n
بٹوا	b ah tx uh aa
بٹوا	b ah tx v aa
بٹورنا	b ah tx ow unk n aa
بٹھانا	b ih txh aa n aa
بپتسمہ	b ah p t ih s m aa
بچپن	b ah ch p ah n
بچھو	b ih t ch uw
بچہ	b ah t ch aa
بچی	b ah ch iy
بڑا	b ah r aa
بڑھاپا	b uh r aa p aa
بڑھنا	b ah r n aa
بکاؤ	b ih k aa ow
بکاؤ	b ih k aa uw
بکرا	b ah k unk aa
بکری	b ah k unk iy
بکس	b ah k s
بکم	b ah k k ah m
بکم	b uh k m
بکھراو	b ih kh unk aa v
بھائی	bh aa iy
بھاجن	bh aa jh ah n
بھارت	bh aa unk ah t
بھاشا	bh aa sh aa
بھالو	bh aa l uw
بھانجا	bh aa n jh aa
بھانجی	bh aa n jh iy
بھانگ	bh aa ng g
بھاگ	bh aa g
بھاگنا	bh aa g n aa
بھتیجا	bh ah t iy jh aa
بھتیجی	bh ah t iy jh iy
بھراتا	bh unk aa t aa
بھرم	bh ah unk ah m
بھرن	bh ah unk ah n
بھرنا	bh ah unk n aa
بھروسہ	bh ah unk ow s ah
بھلوال	bh ah l v aa l
بھلکڑ	bh uh l ah k k ah r
بھنجک	bh ah n jh ah k
بھوت	bh uw t
بھوتنی	bh uw t n iy
بھوتنی	bh uw t ih n iy
بھورا	bh uw unk aa
بھوسڑی	bh ow s r iy
بھولنا	bh uw l n aa
بھومی	bh uw m iy
بھونیشور	bh uw n ey sh v ah unk
بھوٹان	bh uw tx aa n
بھوک	bh uw k
بھوگول	bh uw g ow l
بھکت	bh ah k t
بھکتی	bh ah k t iy
بھکر	bh ah k k ah unk
بھگدڑ	bh ah g d ah r
بھگوان	bh ah g v aa n
بھی	bh iy
بھیا	bh ah y y aa
بھیانک	bh ah y aa n ah k
بھیجنا	bh ey jh n aa
بھید	bh ey d
بھیس	bh ey s
بھیڑ	bh ey r
بھیڑ	bh iy r
بھیک	bh iy k
بہ	b aa
بہاؤالدین	b ah h aa unk uh d d iy n
بہادری	b ah h aa d ah unk iy
بہادری	b ah h aa d uh unk iy
بہار	b ah h aa unk
بہار	b ih h aa unk
بہاراں	b ah h aa unk aa
بہاولنگر	b ah h aa v ah l n ah g ah unk
بہاولپور	b ah h aa v ah l p uw unk
بہت	b ah h ow t
بہت	b ah h uh t
بہتر	b eh t ah unk
بہتر	b ah h ah t t ah unk
بہرا	b ah h unk aa
بہرام	b ey h unk aa m
بہرام	b ah h unk aa m
بہروز	b ey h unk ow z
بہشت	b ih h ih sh t
بہن	b ah h ah n
بہن	b ah h ih n
بہنا	b ah h n aa
بیت	b eh t
بیتا	b iy t aa
بیجا	b ey jh aa
بیجنگ	b ey jh ih ng g
بیخ	b ey unk
بیخ	b iy unk
بیدار	b ey d aa unk
بیر	b iy unk
بیروت	b eh unk uw t
بیزتی	b ey s t iy
بیزتی	b ey z t iy
بیستی	b ey s t iy
بیش	b ey sh
بیشک	b ey sh ah k
بیضہ	b eh z aa
بیعت	b eh y ah t
بیعت	b eh t
بیعت	b eh unk ah t
بیلاروس	b ey l aa unk uw s
بیلجیم	b ey l jh ih y ah m
بیلہ	b ey l aa
بیمار	b iy m aa unk
بیماری	b iy m aa unk iy
بینک	b eh ng k
بیوی	b iy v iy
بیٹا	b ey tx aa
بیٹھنا	b eh txh n aa
بیٹھک	b eh txh ah k
بیچ	b iy ch
بیچنا	b ey ch n aa
بیکر	b ey k ah unk
بیگ	b ey g
بیگ	b eh g
بیگم	b ey g ah m
بے	b ey
ت	t
ت	t ey
تابش	t aa b ih sh
تابندہ	t aa b ih n d aa
تاج	t aa jh
تاجکستان	t aa jh ih k ih s t aa n
تار	t aa unk
تارا	t aa unk aa
تارکین	t aa unk ih k iy n
تاریخ	t aa unk iy unk
تاریخچہ	t aa unk iy unk ch aa
تاریخی	t aa unk iy unk iy
تاریک	t aa unk iy k
تاریکی	t aa unk iy k iy
تازہ	t aa z aa
تاش	t aa sh
تاشقند	t aa sh q ah n d
تال	t aa l
تالا	t aa l aa
تالو	t aa l uw
تالی	t aa l iy
تاناشاہ	t aa n aa sh aa h
تانبا	t aa m b aa
تاپنا	t aa p n aa
تاڑ	t aa r
تاڑی	t aa r iy
تاہم	t aa h ah m
تب	t ah b
تبادلہ	t ah b aa d l unk h
تبادلہ	t ah b aa d ih l unk h
تبدیل	t ah b d iy l
تبریز	t ah b unk ey z
تبصرہ	t ah b s ih unk aa
تتلی	t ih t l iy
تتکالین	t ah t k aa l iy n
تجارتی	t ih jh aa unk ah t iy
تجاوز	t ah jh aa v uh z
تجربہ	t ah jh unk ih b aa
تجزیہ	t ah jh z ih y aa
تجھے	t uh jh ey
تحریک	t ah h unk iy k
تحفظ	t ah h ah f f uh z
تحفہ	t ow h f ah
تحفہ	t ao h f ah
تحقیق	t ah h q iy q
تخت	t ah unk t
تختہ	t ah unk t aa
تخلیق	t ah unk l iy q
تخم	t uh unk m
تخمہ	t uh unk m aa
تخیل	t ah unk ax unk y uh l
ترازو	t ah unk aa z uw
ترانہ	t ah unk aa n aa
تراویح	t ah unk aa v iy h
تربت	t uh unk b ah t
ترجمان	t ah unk jh uh m aa n
ترجمہ	t ah unk jh ah m aa
ترجمہ	t ah unk jh uh m aa
ترجیح	t ah unk jh iy
ترجیح	t ah unk jh iy h
ترس	t ah unk ah s
ترقی	t ah unk unk unk iy
ترقی	t ah unk ah q q iy
ترٹی	t unk uh tx iy
ترک	t uh unk k
ترکستان	t uh unk k ih s t aa n
ترکی	t uh unk k iy
ترکیہ	t uh unk k ih y aa
ترکیے	t uh unk k ih y ey
تریپورہ	t unk iy p uw unk aa
تسلیم	t ah s l iy m
تشریح	t ah sh unk iy h
تشنہ	t ih sh n aa
تشویشناک	t ah sh v iy sh n aa k
تشکیل	t ah sh k iy l
تصاویر	t ah s aa v iy unk
تصدیق	t ah s d iy q
تصور	t ah s ah v v uh unk
تصویر	t ah s v iy unk
تصویرو	t ah s v iy unk ow
تصویروں	t ah s v iy unk ow
تصویریں	t ah s v iy unk eh
تعارف	t aa unk uh f
تعارف	t ah unk aa unk uh f
تعداد	t aa d aa d
تعداد	t ah unk d aa d
تعریف	t aa unk iy f
تعلق	t ah l l ah q
تعلق	t ah unk ah l l uh q
تعلیم	t ah ai l iy m
تغافل	t ah gq aa f uh l
تغییر	t ah gq y iy unk
تفاح	t uh f f aa h
تفصیل	t ah f s iy l
تفنگ	t uh f ah ng g
تقدیر	t ah q d iy unk
تقریبا	t ah q unk iy b ah n
تقلید	t ah q l iy d
تلا	t ah l aa
تلا	t uh l aa
تلاوت	t ih l aa v ah t
تلخ	t ah l unk
تلخ	t ah l ah unk
تلخی	t ah l unk iy
تلسی	t uh l s iy
تلفظ	t ah l ah f f uh z
تلوار	t ah l v aa unk
تم	t uh m
تماشہ	t ah m aa sh aa
تمام	t ah m aa m
تمرکز	t ah m ah unk k uh z
تمغا	t ah m gq aa
تملق	t ah m ah l l uh q
تمنا	t ah m ah n n aa
تمنچہ	t ah m ah n ch aa
تمپ	t uh m p
تمھارا	t uh m aa unk aa
تمھیں	t uh m eh
تمہارا	t uh m h aa unk aa
تمہیں	t uh m h eh
تمیز	t ah m iy z
تن	t ah n
تنازع	t ah n aa z ow unk
تنبولی	t ah m b ow l iy
تندر	t ah n d ah unk
تندر	t uh n d ah unk
تندر	t uh n d uh unk
تندرست	t ah n d uh unk uh s t
تندرستی	t ah n d uh unk uh s t iy
تندور	t ah n d uw unk
تنزانیہ	t ah n z aa n ih y aa
تنظیم	t ah n z iy m
تنظیمی	t ah n z iy m iy
تنقید	t ah ng q iy d
تنگ	t ah ng g
تنہائی	t ah n h aa iy
تو	t ow
تو	t uw
توبہ	t ao b aa
توبہ	t ah uh b aa
توجہ	t ah v ah d jh ow h
توحید	t ao h iy d
تودہ	t ow d
تودہ	t uw d
توران	t uw unk aa n
توقع	t ah v ah q q ow unk
تولد	t ah v ah l l uh d
تولیہ	t ow l ih y ah
تولیہ	t ao l ih y ah
تولیے	t ao l ih y ey
توچا	t v ah ch aa
توڑنا	t ow r n aa
توہین	t ao h iy n
تڑت	t ah r ih t
تکبر	t ah k ah b b uh unk
تکبیر	t ah k b iy unk
تکلیف	t ah k l iy f
تکمیل	t ah k m iy l
تکھان	t ah kh aa n
تکیہ	t ah k y aa
تکیہ	t ah k ih y aa
تگنا	t ih g n aa
تھائیلینڈ	th aa iy l eh n dx
تھوک	th uw k
تھوکنا	th uw k n aa
تہ	t ah h
تہائی	t ih h aa iy
تہجد	t ah h ah d jh uh d
تہجی	t ah h ah jh iy
تہذیب	t ah h z iy b
تہوار	t ih h v aa unk
تہہ	t ah h
تیار	t ax unk y aa unk
تیاری	t ax unk y aa unk iy
تیاگ	t y aa g
تیرا	t ey unk aa
تیراک	t eh unk aa k
تیراکوں	t eh unk aa k ow
تیرنا	t eh unk n aa
تیز	t ey z
تیزاب	t ey z aa b
تیسرا	t iy s unk aa
تیل	t ey l
تیمور	t eh m uw unk
تین	t iy n
تیکھا	t iy kh aa
ث	s
ث	s ey
ثابت	s aa b ih t
ثانیہ	s aa n ih y aa
ثبوت	s ah b uw t
ثروت	s ah unk v ah t
ثقافت	s ah q aa f ah t
ثقالت	s ah q aa l ah t
ثم	s uh m m
ثواب	s ah v aa b
ثورہ	s ao unk aa
ج	jh
ج	jh iy m
جائداد	jh aa ey d aa d
جائداد	jh aa iy d aa d
جائزہ	jh aa y ih z aa
جائپھل	jh aa ih ph ah l
جادو	jh aa d uw
جادوگر	jh aa d uw g ah unk
جارجیا	jh aa unk jh ih y aa
جال	jh aa l
جالندھر	jh aa l ah n dh ah unk
جام	jh aa m
جامعہ	jh aa m ih y aa
جامعہ	jh aa m ih unk aa
جامن	jh aa m ah n
جامن	jh aa m uh n
جامنی	jh aa m n iy
جان	jh aa n
جاننا	jh aa n n aa
جانور	jh aa n v ah unk
جانچنا	jh aa n ch n aa
جانکاری	jh aa n k aa unk iy
جاوید	jh aa v ey d
جاوید	jh aa v iy d
جاپان	jh aa p aa n
جاپانی	jh aa p aa n iy
جاگنا	jh aa g n aa
جاگہ	jh aa g aa
جب	jh ah b
جبرائیل	jh ih b unk aa iy l
جبرالٹر	jh ih b unk aa l tx ah unk
جبوتی	jh ih b uw t iy
جبڑا	jh ah b r aa
جبیل	jh uh b eh l
جتوئی	jh ah t ow iy
جدا	jh uh d aa
جدید	jh ah d iy d
جرأت	jh uh unk unk ah t
جراثیم	jh ah unk aa s iy m
جراح	jh ah unk unk aa h
جراحت	jh ah unk aa h ah t
جرثومہ	jh uh unk s uw m aa
جرح	jh uh unk h
جرسی	jh ah unk s iy
جرم	jh uh unk m
جرمانہ	jh uh unk m aa n aa
جرمن	jh ah unk m ah n
جرمنی	jh ah unk m ah n iy
جرگہ	jh ih unk g aa
جزیرہ	jh ah z iy unk aa
جستجو	jh uh s t ah jh uw
جستجو	jh uh s t uh jh uw
جسور	jh ah s uw unk
جشن	jh ah sh ah n
جعلی	jh aa l iy
جغرافیائی	jh uh gq unk aa f ih y aa iy
جفتی	jh uh f t iy
جل	jh ah l
جلانا	jh ah l aa n aa
جلسہ	jh ah l s aa
جلسہ	jh ih l s ae
جلنا	jh ah l n aa
جلوس	jh uh l uw s
جماعت	jh ah m aa t
جماعت	jh ah m aa unk ah t
جماگی	jh uh m aa g iy
جمعرات	jh uh m aa unk unk aa t
جمعرات	jh uh m ih unk unk aa t
جمعہ	jh uh m unk aa
جموں	jh ah m m uw
جمہوری	jh ah m h uw unk iy
جمہوریت	jh ah m h uw unk ih y ah t
جمہوریہ	jh ah m h uw unk ih y aa
جمہوریہ	jh uh m h uw unk ih y aa
جن	jh ih n
جن	jh ih n n
جناب	jh ah n aa b
جنازو	jh ah n aa z ow
جنازوں	jh ah n aa z ow
جنازہ	jh ah n aa z aa
جنازے	jh ah n aa z ey
جنت	jh ah n n ah t
جنتا	jh ah n t aa
جنتی	jh ah n ah t iy
جنرل	jh ah n unk ah l
جنسی	jh ih n s iy
جنوبی	jh ah n uw b iy
جنوبی	jh uh n uw b iy
جنوری	jh ah n v ah unk iy
جنگ	jh ah ng g
جنگ	jh uh ng g
جنگل	jh ah ng g ah l
جنگلا	jh ah ng g l aa
جنیئو	jh ah n ey uw
جوا	jh uw aa
جوا	jh uh w aa
جوا	jh uh aa
جواب	jh ah w aa b
جواب	jh ah v aa b
جواد	jh ah v v aa d
جواز	jh ah v aa z
جوانی	jh ah v aa n iy
جوت	jh ow t
جوتا	jh uw t aa
جور	jh v ah unk
جوز	jh ao z
جونپوری	jh ao n p uw unk iy
جوڑ	jh ow r
جوکھم	jh ow kh ih m
جوگی	jh ow g iy
جوں	jh uw
جوہر	jh ao h ah unk
جوہری	jh ao h unk iy
جوہی	jh uw h iy
جٹا	jh ah tx aa
جپنا	jh ah p n aa
جڑ	jh ah r
جڑانوالہ	jh ah r aa n v aa l aa
جڑواں	jh uh r w aa
جڑواں	jh uh r v aa
جگ	jh ah g
جگاڑ	jh uh g aa r
جگر	jh ih g ah unk
جگنا	jh ah g n aa
جگنو	jh uh g n uw
جگہ	jh ah g eh
جگہ	jh ah g aa
جگہ	jh ah g ah h
جگہ	jh ah g eh
جھارکھنڈ	jh aa unk kh ah n dx
جھانجھ	jh aa jh
جھاڑنا	jh aa r n aa
جھاڑو	jh aa r uw
جھلمل	jh ih l m ih l
جھنڈا	jh ah n dx aa
جھنگ	jh ah n g
جھولا	jh uw l aa
جھوٹ	jh uw tx
جھوٹ	jh uw txh
جھوٹا	jh uw tx aa
جھوٹھ	jh uw txh
جھیلمی	jh ey l ah m iy
جہاد	jh ih h aa d
جہاز	jh ah h aa z
جہازی	jh ah h aa z iy
جہان	jh ah h aa n
جہاں	jh ah h aa
جہلم	jh ih h l ah m
جہنم	jh ah h ah n n ah m
جہیز	jh ah h ey z
جی	jh iy
جیالا	jh eh y aa l aa
جیالا	jh ih y aa l aa
جیبھ	jh iy bh
جیت	jh iy t
جیش	jh eh sh
جیل	jh ey l
جین	jh eh n
جیوتی	jh y ow t iy
جیومیٹری	jh ih ow m ey tx unk iy
جیون	jh iy v ah n
جیونی	jh iy v ah n iy
ح	h
حائل	h aa ih l
حاجت	h aa jh ah t
حادثہ	h aa d s aa
حاسب	h aa s ih b
حاصل	h aa s ih l
حاضری	h aa z ih unk iy
حافظ	h aa f ih z
حال	h aa l
حالانکہ	h aa l aa k ey
حالانکہ	h aa l aa k iy
حالت	h aa l ah t
حامی	h aa m iy
حب	h ah b
حبش	h ah b ah sh
حبشہ	h ah b sh aa
حبشی	h ah b sh iy
حبقوق	h ah b ah q q uw q
حج	h ah d jh
حجام	h ah d jh aa m
حجرہ	h uh jh unk aa
حدیث	h ah d iy s
حراست	h ih unk aa s ah t
حرام	h ah unk aa m
حرمت	h uh unk m ah t
حرمزئی	h uh unk m ah z ah iy
حساب	h ih s aa b
حسد	h ah s ah d
حسین	h ah s iy n
حسین	h uh s eh n
حسیں	h ah s iy
حشرہ	h ah sh ah unk aa
حشفہ	h ah sh ah f aa
حصہ	h ih s s aa
حضرت	h ah d unk ah t
حضور	h ah z uw unk
حضور	h uh z uw unk
حفاظت	h ih f aa z ah t
حقوق	h uh q uw q
حقہ	h uh q q aa
حقیقت	h ah q iy q ah t
حلال	h ah l aa l
حلب	h ah l ah b
حلقہ	h ah l q aa
حلم	h ih l m
حلم	h uh l m
حلیہ	h uw l ih y aa
حلیہ	h ih l ih y aa
حلیہ	h uh l ih y aa
حمار	h ih m aa unk
حمارہ	h ih m aa unk aa
حماقت	h ah m aa q ah t
حماقت	h ih m aa q ah t
حماقت	h ih m aa unk ah t
حمام	h ah m m aa m
حمایت	h ih m aa y ah t
حمد	h ah m d
حملہ	h ah m l aa
حنا	h ih n aa
حنوکاہ	h ah n uw k aa h
حواری	h ah v aa unk iy
حور	h uw unk
حوصلہ	h ao s l aa
حوصلہ	h ao s ah l aa
حوض	h ao z
حول	h ao l
حویلی	h ah v ey l iy
حکایت	h ih k aa y ah t
حکم	h uh k m
حکومت	h uh k uw m ah t
حکیم	h ah k iy m
حیا	h ah y aa
حیات	h ah y aa t
حیاتیات	h ah y aa t ih y aa t
حیاتین	h ah y aa t iy n
حیران	h eh unk aa n
حیفا	h ah iy f aa
حیفا	h eh f aa
حیوان	h eh v aa n
حیوانیات	h eh v aa n ih y aa t
خ	unk
خ	unk ey
خاتمہ	unk aa t m ah
خاتمہ	unk aa t ih m ah
خاتون	unk aa t uw n
خادم	unk aa d ih m
خار	unk aa unk
خاران	unk aa unk aa n
خارج	unk aa unk ih jh
خارجہ	unk aa unk ih jh aa
خارجی	unk aa unk jh iy
خارجی	unk aa unk ih jh iy
خاص	unk aa s
خاصا	unk aa s aa
خاصی	unk aa s iy
خاطر	unk aa t ih unk
خاقانیت	unk aa q aa n ih y ah t
خال	unk aa l
خالق	unk aa l ih q
خالی	unk aa l iy
خاموش	unk aa m ow sh
خاموشی	unk aa m ow sh iy
خان	unk aa n
خاندان	unk aa n d aa n
خانسامان	unk aa n s aa m aa n
خانساماں	unk aa n s aa m aa
خانوزئی	unk aa n ow z ah iy
خانپور	unk aa n p uw unk
خانہ	unk aa n aa
خانیت	unk aa n ih y ah t
خانیوال	unk aa n ey v aa l
خاکسار	unk aa k s aa unk
خاکستری	unk aa k ih s t ah unk iy
خاکی	unk aa k iy
خبر	unk ah b ah unk
ختم	unk ah t m
ختم	unk ah t ah m
خجیر	unk ah jh iy unk
خجیر	unk uh jh iy unk
خدا	unk uh d aa
خداوند	unk uh d aa v ah n d
خدمت	unk ih d m ah t
خدیو	unk ah d ey v
خدیو	unk ih d ey v
خدیو	unk ih d iy v
خراب	unk ah unk aa b
خراش	unk ah unk aa sh
خربوزہ	unk ah unk b uw z aa
خرد	unk ih unk ah d
خرد	unk uh unk d
خرس	unk ih unk s
خرگوش	unk ah unk g ow sh
خریدنا	unk ah unk iy d n aa
خریدوانا	unk ah unk iy d v aa n aa
خزاں	unk ah z aa
خزاں	unk ih z aa
خسارہ	unk ih s aa unk aa h
خسرہ	unk ah s unk aa
خشبو	unk uh sh b uw
خشت	unk ih sh t
خشم	unk ah sh m
خصوصا	unk ah s uw s ah n
خصوصا	unk uh s uw s ah n
خصوصی	unk uh s uw s iy
خضدار	unk uh z d aa unk
خط	unk ah t
خطبا	unk uh t ah b aa
خطبہ	unk uh t b aa
خطہ	unk ih t t aa
خطیب	unk ah t ey b
خطیب	unk ah t iy b
خطیر	unk ah t iy unk
خطیہ	unk ah t ih y y aa
خفیہ	unk uh f y aa
خفیہ	unk uh f ih y aa
خلا	unk ah l aa
خلاف	unk ih l aa f
خلافت	unk ih l aa f ah t
خلفا	unk uh l ah f aa
خلق	unk ah l q
خلقت	unk ah l q ah t
خلقت	unk ih l q ah t
خلل	unk ah l ah l
خلیج	unk ah l iy jh
خلیفہ	unk ah l iy f aa
خنجر	unk ah n jh ah unk
خواب	kh aa b
خواتین	unk aa t iy n
خواتین	unk ah v aa t iy n
خواجہ	unk w aa jh aa
خواجہ	unk aa jh aa
خواہ	unk w aa h
خواہ	unk aa h
خواہر	unk aa h ah unk
خواہش	unk w aa h ih sh
خواہش	unk aa h ih sh
خوب	unk uw b
خوبانی	unk uw b aa n iy
خوبصورت	unk uw b s uw unk ah t
خود	unk w uh d
خود	unk uh d
خودمختاری	unk uh d m uh unk t aa unk iy
خودکش	unk uh d k uh sh
خودکشی	unk uh d k ah sh iy
خودکشی	unk uh d k uh sh iy
خوراک	unk uh unk aa k
خوش	unk uh sh
خوشاب	unk uh sh aa b
خوشبو	unk uh sh b uw
خوشبودار	unk uh sh b uw d aa unk
خوشی	unk uh sh iy
خوف	unk ao f
خوفناک	unk ao f n aa k
خول	unk ow l
خون	unk uw n
خوک	unk uw k
خوں	unk uw
خيرپور	unk eh unk p uw unk
خچر	unk ah t ch ah unk
خیابان	unk ih y aa b aa n
خیال	unk ey y aa l
خیال	unk y aa l
خیال	unk ah y aa l
خیر	unk eh unk
خیریت	unk eh unk ih y ah t
خیلا	unk ey l aa
خیمہ	unk eh m aa
د	d
د	d aa l
داؤد	d aa uw d
داخل	d aa unk ih l
داخلہ	d aa unk ih l aa
دادا	d aa d aa
دادو	d aa d uw
دادی	d aa d iy
دار	d aa unk
داردر	d aa unk ih d r
دارو	d aa unk uw
داریل	d aa unk ey l
داستان	d aa s t aa n
داستان	d aa s t aa
داعش	d aa ih sh
داغ	d aa gq
داغستان	d aa gq ih s t aa n
دال	d aa l
دالبندین	d aa l b ah n d iy n
دام	d aa m
دانت	d aa t
دانتی	d aa t iy
دانش	d aa n ih sh
داڑم	d aa r ih m
دایاں	d aa y aa
دبئی	d uh b ah iy
دباؤ	d ah b aa ow
دبستان	d ah b ih s t aa n
دجلہ	d ah jh l aa
دختر	d uh unk t ah unk
دخمہ	d ah unk m
دربار	d ah unk b aa unk
درجات	d ah unk jh aa t
درجہ	d ah unk jh aa
درخت	d ah unk ah unk t
درخش	d ah unk ah unk sh
درخواست	d ah unk kh aa s t
درد	d ah unk d
دردو	d ah unk d ow
دردوں	d ah unk d ow
درزی	d ah unk z iy
درست	d uh unk uh s t
درفش	d ah unk ah f sh
درفش	d ih unk ah f sh
درفش	d uh unk ah f sh
دروازہ	d ah unk v aa z aa
دروازہ	d ih unk v aa z aa
دروبست	d ah unk ow b ah s t
درود	d uh unk uw d
درگ	d uh unk g
درگاہ	d ah unk g aa h
درہال	d ah unk h aa l
دری	d uh unk iy
دریا	d ah unk y aa
دریاچہ	d ah unk ih y aa ch aa
دریجی	d uh unk eh jh iy
دزد	d uh z d
دس	d ah s
دستانو	d ah s t aa n ow
دستانوں	d ah s t aa n ow
دستانہ	d ah s t aa n aa
دستانے	d ah s t aa n ey
دستاویز	d ah s t aa v ey z
دستور	d ah s t uw unk
دستک	d ah s t ah k
دستکاری	d ah s t k aa unk iy
دستہ	d ah s t aa
دسمبر	d ih s ah m b ah unk
دسواں	d ah s v aa
دشت	d ah sh t
دشمن	d uh sh m ah n
دشک	d ah sh ah k
دعا	d uh unk aa
دعوت	d aa v ah t
دعوت	d ah unk v ah t
دعوی	d aa v aa
دعوی	d ah unk v aa
دفاع	d ih f aa unk
دفتر	d ah f t ah unk
دفعہ	d ah f unk aa
دفنانا	d ah f n aa n aa
دقت	d ih q q ah t
دقیقہ	d ah q iy q aa
دل	d ih l
دلدادہ	d ih l d aa d aa
دلربا	d ih l unk uh b aa
دلو	d ih l ow
دلوں	d ih l ow
دلچسپ	d ih l ch ah s p
دلی	d ih l l iy
دم	d ah m
دم	d uh m
دماغ	d ih m aa gq
دمشق	d ah m ih sh q
دن	d ih n
دنداسہ	d ah n d aa s aa
دنوں	d ih n ow
دنڈ	d ah n dx
دنیا	d uh n y aa
دنیا	d uh n ih y aa
دنیاوی	d uh n y aa v iy
دنیور	d ah n y ow unk
دو	d ow
دوائی	d ah w aa iy
دوائی	d ah v aa iy
دوات	d ah v aa t
دوبارہ	d ow b aa unk aa
دودمان	d uw d m aa n
دودھ	d uw dh
دور	d uw unk
دور	d ao unk
دوربین	d uw unk b iy n
دوردرشن	d uw unk d ah unk sh ah n
دورلیکھ	d uw unk l ey kh
دوزخ	d ow z ah unk
دوست	d ow s t
دوستانہ	d ow s t aa n aa
دوستی	d ow s t iy
دوسرا	d uw s unk aa
دوش	d ow sh
دوم	d uh v ah m
دونا	d uw n aa
دونمہ	d uw n m aa
دوپہر	d ow p ah h ah unk
دوڑنا	d ao r n aa
دوکی	d uw k iy
دوگنا	d ow g uh n aa
دژ	d ah zh
دژ	d ih zh
دژم	d ih zh ah m
دکھ	d uh kh
دکھانا	d ih kh aa n aa
دکھانا	d uh kh aa n aa
دکھن	d ah k kh ih n
دگنا	d uh g n aa
دھات	dh aa t
دھادر	dh aa d ah unk
دھارا	dh aa unk aa
دھارمک	dh aa unk m ih k
دھاندل	dh aa n d ah l
دھاندلی	dh aa n d l iy
دھبا	dh ah b b aa
دھرتی	dh ah unk t iy
دھرم	dh ah unk m
دھمال	dh ah m m aa l
دھماکہ	dh ah m aa k aa h
دھن	dh ah n
دھن	dh uh n
دھندا	dh ah n d aa
دھندھا	dh ah n dh aa
دھواں	dh uw aa
دھوج	dh v ah jh
دھوسر	dh uw s ah r
دھول	dh uw l
دھونا	dh ow n aa
دھونا	dh uw n aa
دھوپ	dh uw p
دھڑکن	dh ah r k ah n
دھیریہ	dh eh unk y
دہ	d ey h
دہ	d iy h
دہ	d ah h
دہائی	d ah h aa iy
دہان	d ah h aa n
دہشت	d ah h sh ah t
دہقان	d ey h q aa n
دہقان	d ah h q aa n
دہقان	d ih h q aa n
دہلوی	d ey h l ah v iy
دہلوی	d ih h l ah v iy
دہلی	d eh l iy
دہلی	d eh l iy
دہلی	d ih h l iy
دہی	d ah h iy
دہیز	d ah h ey z
دیا	d ah y aa
دیا	d ih y aa
دیاوان	d ah y aa v aa n
دیدار	d iy d aa unk
دیروز	d iy unk ow z
دیز	d ey z
دیس	d ey s
دیسی	d ey s iy
دیش	d ey sh
دیشج	d ey sh ah jh
دینا	d ey n aa
دینی	d iy n iy
دینے	d ey n ey
دیوانہ	d iy v aa n ah
دیوبندی	d ey v b ah n d iy
دیوناگری	d ey ow n aa g unk iy
دیپ	d iy p
دیپک	d iy p ah k
دیپکا	d iy p ih k aa
دیکھنا	d ey kh n aa
دیگچی	d ey g ch iy
ذ	z
ذ	z aa l
ذائقہ	z aa y q aa
ذات	z aa t
ذرہ	z ah unk unk aa
ذریعہ	z ah unk ih y aa
ذلت	z ih l ah t
ذلیل	z ah l iy l
ذوق	z ao q
ذکر	z ah k ah unk
ذکر	z ih k unk
ذیابیطس	z ih y aa b iy t ah s
ر	unk
ر	unk ey
رؤسا	unk uh unk ah s aa
رئیس	unk ah unk iy s
رائس	unk aa ih s
رائے	unk aa ey
رائے	unk aa y
رابطہ	unk aa b t aa
رات	unk aa t
راتا	unk aa t aa
راج	unk aa jh
راجا	unk aa jh aa
راجبھاشا	unk aa jh bh aa sh aa
راجدھانی	unk aa jh dh aa n iy
راجستھان	unk aa jh ah s th aa n
راجستھانی	unk aa jh ah s th aa n iy
راجشاہی	unk aa jh s h aa h iy
راجنیہ	unk aa jh ah n y aa
راجوری	unk aa jh ao unk iy
راز	unk aa z
راستہ	unk aa s t aa
راضی	unk aa z iy
رال	unk aa l
رامائن	unk aa m aa y ah n
ران	unk aa n
رانجھا	unk aa n jh aa
رانی	unk aa n iy
راولپنڈی	unk aa v ah l p ih n dx iy
راکٹ	unk aa k ih tx
راکھ	unk aa kh
راکھس	unk aa kh ah s
راکھشس	unk aa k sh ah s
راہ	unk aa h
راہب	unk aa h ih b
راہبہ	unk aa h ih b aa
راہداری	unk aa h d aa unk iy
رب	unk ah b
ربا	unk ah b b aa
رباعی	unk uh b aa unk iy
ربوہ	unk ah b v unk h
رتبہ	unk uh t b aa
رتن	unk ah t ah n
رجا	unk ah jh aa
رجل	unk ah jh uh l
رخشان	unk ah unk sh aa n
رخصتی	unk uh unk s ah t iy
رد	unk ah d d
رسالہ	unk ih s aa l aa
رستم	unk uh s t ah m
رسن	unk ah s ah n
رسول	unk ah s uw l
رسی	unk ah s iy
رسید	unk ah s iy d
رسیدو	unk ah s iy d ow
رسیدوں	unk ah s iy d ow
رسیدیں	unk ah s iy d eh
رشتہ	unk ih sh t aa
رشوت	unk ih sh v ah t
رشی	unk ih sh iy
رضا	unk ah z aa
رضیع	unk ah z iy unk
رفتار	unk ah f t aa unk
رفتن	unk ah f t ah n
رفتن	unk uh f t ah n
رفع	unk ah f unk
رفقا	unk uh f ah q aa
رقص	unk ah q s
رمزی	unk ah m z iy
رمضان	unk ah m z aa n
رمضان	unk ah m ah z aa n
رمہ	unk ah m aa
رنڈی	unk ah n dx iy
رنگ	unk ah ng g
رنگت	unk ah ng g ah t
رنگولی	unk ah ng g ow l iy
رنگپور	unk ah n g p uw unk
روان	unk ah v aa n unk unk ah w aa n
روانڈا	unk ah v aa n dx aa
روانگی	unk ah v aa ng g iy
روانہ	unk ah v aa n aa
روایت	unk ih v aa y ah t
روح	unk uw h
روحانی	unk uw h aa n iy
روز	unk ow z
روزن	unk ao z ah n
روزنامہ	unk ow z n aa m aa
روزہ	unk ow z aa
روس	unk uw s
روشن	unk ow sh ah n
روشن	unk ao sh ah n
روشنی	unk ow sh n iy
روشنی	unk ao sh n iy
روغن	unk ow gq ah n
روغن	unk ao gq ah n
رومال	unk uw m aa l
رومانیہ	unk ow m aa n ih y aa
رومی	unk uw m iy
رونا	unk ow n aa
روٹی	unk ow tx iy
روپ	unk uw p
روپیہ	unk uw p y aa
روپیہ	unk uw p ah y aa
روچڈیل	unk ow ch dx ey l
روچڈیل	unk aa ch dx ey l
روچڈیل	unk ao ch dx ey l
روی	unk ah v iy
رویئہ	unk ah v ax unk ah
رویہ	unk ah v ax unk y ah
رڑک	unk ah r ah k
رکاوٹ	unk uh k aa v ah tx
رکت	unk ah k t
رکشا	unk ah k sh aa
رکعت	unk ah k unk ah t
رگوید	unk ih g w ey d
رگوید	unk ih g v ey d
رہائش	unk ah h aa ih sh
رہائش	unk ih h aa ih sh
رہبر	unk ah h b ah unk
رہنا	unk ah h n aa
ریاست	unk ih y aa s ah t
ریاستہا	unk ih y aa s ah t h aa
ریاض	unk ih y aa z
ریاضی	unk ih y aa z iy
ریب	unk eh b
ریت	unk ey t
ریختہ	unk ey unk t aa
ریش	unk ey sh
ریش	unk iy sh
ریشم	unk ey sh ah m
ریشہ	unk ey sh aa
ریشہ	unk iy sh aa
ریپھ	unk ey ph
ریچھ	unk iy ch
ریڈیو	unk ey dx ih y ow
ریکھا	unk ey kh aa
ز	z
ز	z ey
زائر	z aa y ih unk
زار	z aa unk
زایندہ	z aa y ah n d
زایندہ	z aa y ih n d
زبان	z ah b aa n
زبان	z uh b aa n
زبردستی	z ah b ah unk d ah s t iy
زخم	z ah unk m
زرافہ	z ih unk aa f ah h
زرتشت	z ah unk t ah sh t
زردوزی	z ah unk d ow z iy
زرشک	z ih unk ih sh k
زعفران	z aa f unk aa n
زمانہ	z ah m aa n aa
زمین	z ah m iy n
زن	z ah n
زنجیر	z ah n jh iy unk
زندگی	z ih n d ah g iy
زندہ	z ih n d aa
زنگ	z ah ng g
زنگبار	z ah ng g b aa unk
زنگی	z ah ng g iy
زور	z ow unk
زور	z uw unk
زوردار	z ow unk d aa unk
زون	z ow n
زيربند	z ey unk b ah n d
زکات	z ah k aa t
زکریا	z ah k ah unk ih y y aa
زکوۃ	z ah k aa t
زہری	z ah h unk iy
زہیب	z uh h ey b
زیادتی	z y aa d t iy
زیادتی	z ih y aa d ah t iy
زیارت	z ih y aa unk ah t
زیتون	z eh t uw n
زیور	z ey v ah unk
س	s
س	s iy n
سؤر	s uw ah unk
سؤر	s uw unk
سا	s aa
سائز	s aa ih z
سائنس	s aa ey n s
سائنس	s aa ih n s
سائنسدان	s aa ih n s d aa n
سائنسی	s aa ey n s iy
سائنسی	s aa ih n s iy
سائیکل	s aa iy k ih l
سات	s aa t
ساتواں	s aa t v aa
ساتھ	s aa th
ساتھی	s aa th iy
ساحل	s aa h ih l
ساحلی	s aa h ih l iy
سارا	s aa unk aa
سازش	s aa z ih sh
سال	s aa l
سالانہ	s aa l aa n aa
سالگرہ	s aa l g ih unk ah h
سامراجیہ	s aa m unk aa jh y
سامعین	s aa m ey unk iy n
سامی	s aa m iy
سامیہ	s aa m ih y aa
سانبہ	s aa m b aa
سانس	s aa n s
سانولا	s aa v l aa
سانپ	s aa p
ساودھان	s aa v dh aa n
ساڑی	s aa r iy
ساکشیہ	s aa k sh y
ساگر	s aa g ah unk
ساہتیہ	s aa h ih t y h
ساہیوال	s aa h iy v aa l
سب	s ah b
سبد	s ah b uh d
سبز	s ah b z
سبزی	s ah b z iy
سبھا	s ah bh aa
سبی	s ih b iy
ستارہ	s ih t aa unk aa
ستارے	s ih t aa unk ey
ستم	s ih t ah m
ستون	s uh t uw n
سجدہ	s ah jh d aa
سحری	s ah h ah unk iy
سخی	s ah unk iy
سدابہار	s ah d aa b ah h aa unk
سدن	s ah d ah n
سدھارنا	s uh dh aa unk n aa
سدھارک	s uh dh aa unk ah k
سرائیکی	s ah unk aa iy k iy
سراب	s ah unk aa b
سرانان	s ah unk aa n aa n
سرحد	s ah unk h ah d
سرخ	s uh unk unk
سرخی	s uh unk unk iy
سردیاں	s ah unk d ih y aa
سرزمین	s ah unk z ah m iy n
سرسائی	s ah unk s aa iy
سرسوتی	s ah unk s uw t iy
سرسوتی	s ah unk ah s v ah t iy
سرسوں	s ah unk s ow
سرشت	s ah unk ih sh t
سرشپ	s ah unk sh ah p
سرفروش	s ah unk f ah unk ow sh
سرما	s ah unk m aa
سرما	s uh unk m aa
سرمایہ	s ah unk m aa y aa
سرمہ	s uh unk m aa
سرور	s uh unk uw unk
سرورق	s ah unk v ah unk ah q
سروش	s ah unk ow sh
سرونام	s ah unk v n aa m
سرکار	s ah unk k aa unk
سرکس	s ah unk k ah s
سرگ	s uh unk g
سرگرم	s ah unk g ah unk m
سرگرمی	s ah unk g ah unk m iy
سرگودھا	s ah unk g ow dh aa
سرہانہ	s ih unk h aa n aa
سریانی	s uh unk y aa n iy
سریر	s ah unk iy unk
سریع	s ah unk iy
سزا	s ah z aa
سسا	s ah s s aa
سسا	s uh s s aa
سست	s uh s t
سستا	s ah s t aa
سستی	s ah s t iy
سستی	s uh s t iy
سسر	s ih s ih unk
سسر	s uh s ah unk
سطح	s ah t ah h
سغدی	s uh gq d iy
سفارت	s ih f aa unk ah t
سفارش	s ih f aa unk ih sh
سفال	s ih f aa l
سفر	s ah f ah unk
سفید	s ah f ey d
سفیر	s ah f iy unk
سلاح	s ih l aa
سلام	s ah l aa m
سلامت	s ah l aa m ah t
سلامتی	s ah l aa m t iy
سلجوق	s ah l jh uw q
سلجوقی	s ah l jh uw q iy
سلسلہ	s ih l s ih l aa
سلطان	s uh l t aa n
سلطنت	s ah l t ah n ah t
سلوواکیہ	s l ow v aa k ih y aa
سلوک	s ah l uw k
سلوک	s uh l uw k
سلہٹ	s ih l h ah tx
سلیمان	s uh l eh m aa n
سمئے	s ah m ah y
سماج	s ah m aa jh
سمادھان	s ah m aa dh aa n
سماس	s ah m aa s
سماعت	s ah m aa unk ah t
سماپت	s ah m aa p t
سماپن	s ah m aa p ah n
سماچار	s ah m aa ch aa unk
سمبڑیال	s ah m b r ih y aa l
سمجھ	s ah m ah jh
سمجھدار	s ah m ah jh d aa unk
سمجھنا	s ah m ah jh n aa
سمجھوتہ	s ah m jh ao t aa
سمدائے	s ah m uh d aa ey
سمدر	s ah m uh d r
سمراٹ	s ah m unk aa tx
سمرتی	s m unk ih t iy
سمرتی	s ah m ah unk t iy
سمرتی	ih s m unk ih t iy
سمرقند	s ah m ah unk q ah n d
سمسم	s ih m s ih m
سمع	s ah m unk
سمندر	s ah m ah n d ah unk
سمندر	s ah m uh n d ah unk
سمندری	s ah m uh n d unk iy
سموسہ	s ah m ow s aa
سموہ	s ah m uw h
سمپردائے	s ah m p ah unk d aa ey
سمپردائے	s ah m p unk ah d aa ey
سمکالین	s ah m k aa l iy n
سمکھ	s ah m m uh kh
سمین	s ah m iy n
سن	s ih n
سناتن	s ah n aa t ah n
سنانا	s uh n aa n aa
سناٹا	s ah n n aa tx aa
سنت	s ah n t
سنت	s uh n n ah t
سنتان	s ah n t aa n
سنترا	s ah n t ah unk aa
سنترا	s ah n t unk aa
سنجھا	s ah n jh aa
سندر	s uh n d ah unk
سندھ	s ih n dh
سندھی	s ih n dh iy
سندیش	s ah n d ey sh
سندیہ	s ah n d ey h
سنسار	s ah n s aa unk
سنسکرت	s ah n s k unk ih t
سنشیہ	s ah n sh ah y aa
سننا	s uh n n aa
سنگ	s ah ng g
سنگاپور	s ih ng g aa p uw unk
سنگم	s ah ng g ah m
سنگھ	s ih ng g
سنگھرش	s ah ng g ah unk sh
سنگیت	s ah ng g iy t
سنہ	s ih ng h
سنیوگ	s ax y ow g
سنیچر	s ah n iy ch ah unk
سوئی	s uw iy
سوادو	s v aa d uw
سوال	s ah w aa l
سوال	s ah v aa l
سوالات	s ah v aa l aa t
سوالو	s ah v aa l ow
سوالوں	s ah v aa l ow
سوانگ	s v aa ng g
سواگت	s v aa g ah t
سوتا	s ow t aa
سوتیلا	s ao t ey l aa
سوتے	s ow t ey
سودا	s ao d aa
سوراب	s uw unk aa b
سورج	s uw unk ah jh
سورہ	s uw unk aa
سوری	s uw unk iy
سوریہ	s uw unk y
سوریہ	s uw unk ih y aa
سوستک	s v ah s t ih k
سوغات	s ao gq aa t
سوم	s ow m
سونا	s ow n aa
سونا	s uw n aa
سويمور	s v ah y ah m v ah unk
سوپن	s v ah p n
سوچنا	s ow ch n aa
سوڈان	s uw dx aa n
سوکھا	s uw kh aa
سویٹزرلینڈ	s v iy tx z ah unk l eh n dx
سویڈن	s v iy dx ah n
سپارہ	s ih p aa unk aa
سپاس	s ih p aa s
سپاس	s uh p aa s
سپاہ	s ih p aa h
سپاہنی	s ih p aa h n iy
سپاہی	s ih p aa h iy
سپتاہ	s ah p t aa h
سپنا	s ah p n aa
سچ	s ah ch
سڑک	s ah r ah k
سکا	s ah k aa
سکنا	s ah k n aa
سکندر	s ih k ah n d ah unk
سکھ	s ih kh
سکھر	s ah k kh ah unk
سکہ	s ih k k ah
سگ	s ah g
سگریٹ	s ih g unk ey tx
سہایک	s ah h aa y ah k
سہج	s ah h ah jh
سہس	s ah h ah s
سہمانا	s ah h m aa n aa
سہمت	s ah h m ah t
سہمنا	s ah h ah m n aa
سہواس	s ah h v aa s
سہولت	s ah h uw l ah t
سہولت	s uh h uw l ah t
سہیلی	s ah h ey l iy
سیاحت	s ih y aa h ah t
سیارہ	s ah y y aa unk aa
سیاست	s ih y aa s ah t
سیاستدان	s ih y aa s ah t d aa n
سیاسی	s ih y aa s iy
سیالکوٹ	s ih y aa l k ow tx
سیب	s ey b
سیخ	s iy unk
سیر	s eh unk
سیلاب	s eh l aa b
سینکڑا	s eh ng k ah r aa
سینکڑا	s eh ng k r aa
سینگ	s iy ng g
سینیٹر	s iy n ey tx ah unk
سیٹھا	s iy txh aa
سیڑھی	s iy r iy
سیکھنا	s iy kh n aa
سے	s ey
ش	sh
ش	sh iy n
شاباش	sh aa b aa sh
شاخ	sh aa unk
شاد	sh aa d
شادی	sh aa d iy
شارجہ	sh aa unk jh aa h
شاستر	sh aa s t ah unk
شاسن	sh aa s ah n
شاسک	sh aa s ah k
شاعر	sh aa unk ih unk
شاعرہ	sh aa unk ih unk aa
شاعری	sh aa unk ih unk iy
شام	sh aa m
شامل	sh aa m ih l
شان	sh aa n
شانتی	sh aa n t iy
شاور	sh aa v ah unk
شاپر	sh aa p ah unk
شاگرد	sh aa g ih unk d
شاہراہ	sh aa h unk aa h
شاہی	sh aa h iy
شاہین	sh aa h iy n
شاید	sh aa y ah d
شب	sh ah b
شبد	sh ah b d
شبدکوش	sh ah b d ah k ow sh
شبنم	sh ah b n ah m
شبھ	sh uh bh
شتابدی	sh ah t aa b d iy
شترو	sh ah t unk uw
شتک	sh ah t ah k
شجر	sh ah jh ah unk
شخص	sh ah unk s
شدت	sh ih d d ah t
شراب	sh ah unk aa b
شرارتی	sh eh unk aa unk t iy
شرارتی	sh ah unk aa unk ah t iy
شرط	sh ah unk t
شرطی	sh uh unk t iy
شرفا	sh uh unk ah f aa
شرم	sh ah unk m
شرمگیں	sh ah unk m g iy
شرک	sh ih unk k
شرکرا	sh ah unk k ah unk aa
شریر	sh ah unk iy unk
شریعت	sh ah unk iy unk ah t
شرینگر	sh unk iy n ah g ah unk
ششن	sh ih sh n
ششک	sh ah sh ah k
شعر	sh ey unk
شعرا	sh uh unk ah unk aa
شعلوں	sh uh ai l ey
شعلہ	sh uh ai l aa
شعلے	sh uh ai l ey
شعیب	sh uh unk eh b
شفا	sh ih f aa
شفقت	sh ah f q ah t
شفیق	sh ah f iy q
شقرا	sh ah q unk aa
شلیہ	sh ah l y aa
شمال	sh ih m aa l
شمال	sh uh m aa l
شمشیر	sh ah m sh ey unk
شمشیر	sh ah m sh iy unk
شناخت	sh ih n aa unk t
شنتانو	sh ah n t ah n uw
شوربا	sh ow unk b aa
شوق	sh ao q
شوپیاں	sh ow p ih y aa
شوہر	sh ao h ah unk
شيخوپورہ	sh ey unk uw p uw unk aa
شکار	sh ih k aa unk
شکارپور	sh ih k aa unk p uw unk
شکایت	sh ih k aa y ah t
شکتی	sh ah k t iy
شکر	sh ah k ah unk
شکر	sh uh k unk
شکر	sh uh k r
شکریہ	sh uh k unk ih y aa
شگن	sh ah g uh n
شہادت	sh ah h aa d ah t
شہباز	sh ah h b aa z
شہتوت	sh ah h t uw t
شہدا	sh uh h ah d aa
شہر	sh ah h unk
شہروز	sh ah h unk ow z
شہری	sh ah h unk iy
شہزادہ	sh ah h z aa d aa
شہلا	sh ah h l aa
شہنشاہ	sh ah h ah n sh aa h
شہنشاہ	sh ah h ax sh aa h
شہید	sh ah h iy d
شہیدو	sh ah h iy d ow
شہیدوں	sh ah h iy d ow
شیخ	sh ey unk
شیدا	sh ey d aa
شیدا	sh eh d aa
شیر	sh ey unk
شیر	sh iy unk
شیشہ	sh iy sh aa
شیطان	sh eh t aa n
شیفیلڈ	sh eh f iy l dx
شیو	sh ey v
شیو	sh iy v
شیکھاواٹی	sh ey kh aa v aa tx iy
شے	sh ey
ص	s
ص	s v aa d
صائب	s aa ih b
صابر	s aa b ih unk
صابن	s aa b uh n
صاحب	s aa b
صاحب	s aa h ah b
صاحب	s aa h ih b
صارف	s aa unk ih f
صارفین	s aa unk ih f iy n
صاف	s aa f
صالح	s aa l iy h
صبح	s uh b uw h
صبح	s uh b ah h
صبح	s uh b h
صبر	s ah b ah unk
صبر	s ah b unk
صحافی	s ah h aa f iy
صحافی	s ih h aa f iy
صحت	s ey h ah t
صحت	s ih h ah t
صحن	s ah h n
صحیح	s ah iy
صحیح	s ah h iy
صدا	s ah d aa
صدقہ	s ah d q aa
صعب	s aa b
صعب	s ah unk b
صغیر	s ah gq iy unk
صفائی	s ah f aa iy
صفائی	s ih f aa iy
صفحہ	s ah f ah
صفحہ	s ah f h ah
صفرواں	s ih f ah unk v aa
صلاح	s ah l aa h
صلاحیت	s ah l aa h ih y y ah t
صلوۃ	s ah l aa t
صلہ	s ih l ah
صلی	s ah l l aa
صلیب	s ah l iy b
صلیبی	s ah l iy b iy
صنعت	s ah n unk ah t
صنم	s ah n ah m
صوابی	s w aa b iy
صوبہ	s uw b aa
صورت	s uw unk ah t
ض	z
ض	z v aa d
ضابطہ	z aa b ih t aa
ضبط	z ah b t
ضد	z ih d
ضدی	z ih d d iy
ضرر	z ah unk ah unk
ضرور	z uh unk uw unk
ضرورت	z ah unk uw unk ah t
ضروری	z ah unk uw unk iy
ضروری	z uh unk uw unk iy
ضلع	z ih l aa
ضم	z ah m
ضمانت	z ah m aa n ah t
ضیافت	z y aa f ah t
ط	t
ط	t ow ey
طاعون	t aa unk uw n
طاقت	t aa q ah t
طاقتور	t aa q ah t v ah unk
طالبان	t aa l ih b aa n
طبق	t ah b ah q
طبلہ	t ah b l aa
طبی	t ih b b iy
طبیب	t ah b iy b
طبیعت	t ah b iy unk ah t
طبیعی	t ah b iy unk iy
طبیعیات	t ah b iy unk ih y y aa t
طرابلس	t ah unk aa b uh l uh s
طرح	t ah unk aa
طرح	t ah unk ah h
طرح	t ah unk h
طرف	t ah unk ah f
طریقہ	t ah unk iy q aa
طشتری	t ah sh t ah unk iy
طعام	t ah unk aa m
طفل	t ih f l
طلاق	t ah l aa q
طلعت	t ah l ah t
طلوع	t uh l uw unk
طوائف	t ah v aa ih f
طوبی	t uw b aa
طور	t uw unk
طور	t ao unk
طوفان	t uw f aa n
طیارہ	t ah y y aa unk aa
طیب	t iy b
طیب	t ah y y ih b
طیر	t eh unk
ظ	z
ظ	z ow ey
ظالم	z aa l ih m
ظرف	z ah unk ah f
ظفر	z ah f ah unk
ظلم	z uh l m
ع	ey
ع	ow
ع	aa
ع	eh n
ع	ai
عائلہ	unk aa ih l aa
عائلی	unk aa ih l iy
عابد	unk aa b ih d
عابدہ	ai aa b ih d aa
عادت	aa d ah t
عاشق	unk aa sh ih q
عاصی	aa s iy
عالم	aa l ah m
عالم	aa l ih m
عالیہ	unk aa l ih y aa
عام	aa m
عاملہ	ai aa m ih l aa
عبادت	ih b aa d ah t
عبادتی	ih b aa d ah t iy
عبرانی	ih b unk aa n iy
عبری	ih b unk iy
عجائب	ah jh aa ey b
عجائب	ah jh aa ih b
عجائبات	ah jh aa ih b aa t
عجمی	ah jh ah m iy
عجوبہ	ah jh uw b aa
عجیب	ah jh iy b
عدالت	ah d aa l ah t
عدس	unk ah d ah s
عدم	unk ah d ah m
عراق	ih unk aa q
عربستان	unk ah unk ah b ih s t aa n
عربی	unk ah unk ah b iy
عرش	unk ah unk sh
عرشی	unk ah unk sh iy
عرض	ah unk z
عرضی	ah unk z iy
عرق	unk ah unk ah q
عزیز	ah z iy z
عشائیہ	unk ih sh aa ih y aa
عشق	unk ih sh q
عضو	uh z v
عطر	unk ih t unk
عظم	unk ah z m
عظیم	ah z iy m
عظیم	unk ah z iy m
عفو	unk ah f uh v v
عفو	unk ah f v
عقل	unk ah q l
عقیلہ	ah q iy l aa
علاج	unk ih l aa jh
علاقہ	unk ih l aa q aa
علم	ah l ah m
علم	ih l m
علما	uh l ah m aa
علمی	ih l m iy
علمیات	ih l m ih y aa t
علوم	unk uh l uw m
علی	unk ah l iy
علی	unk ah l aa
علی	unk ah l ah y
علیحدگی	unk ah l eh h ih d ah g iy
علیحدہ	unk ah l eh h ih d aa
علینہ	ah l iy n aa
عمان	ow m aa n
عمان	ah m m aa n
عمدہ	unk uh m d aa
عمر	uh m ah unk
عمر	uh m r
عمران	unk ih m unk aa n
عمرکوٹ	unk uh m ah unk k ow tx
عمل	ah m ah l
عملہ	unk ah m ah l aa
عموما	ah m uw m ah n
عموما	uh m uw m ah n
عمومی	uh m uw m iy
عنب	ih n ey b
عنصر	uh n s ah unk
عنصر	unk uh n s uh unk
عنوان	ah n v aa n
عنوان	unk uh n v aa n
عوام	unk ah v aa m
عورت	ow unk ah t
عورت	ao unk ah t
عورتو	ao unk t ow
عورتو	ao unk ah t ow
عورتوں	ao unk t ow
عورتوں	ao unk ah t ow
عورتیں	ao unk t eh
عورتیں	ao unk ah t eh
عکرشہ	unk ih k unk ah sh aa
عکس	unk ah k s
عہد	ah h ah d
عہدہ	uh h d aa
عیادت	ah y aa d ah t
عیادت	ih y aa d ah t
عیاشی	unk ah y y aa sh iy
عیاشی	unk ax unk y aa sh iy
عیاں	unk ah y aa
عید	unk iy d
عیسائی	unk iy s aa iy
عیسائیت	unk iy s aa ih y ah t
عیسی	iy s aa
عیش	unk eh sh
عین	unk eh n
عینک	eh n ah k
غ	gq
غ	gq eh n
غائب	gq aa y ah b
غار	gq aa unk
غالبا	gq aa l ih b ah n
غالی	gq aa l iy
غدار	gq ah d d aa unk
غذا	gq ih z aa
غرض	gq ah unk ah z
غرناطہ	gq ah unk n aa t aa h
غروب	gq uh unk uw b
غرور	gq uh unk uw unk
غریب	gq ah unk iy b
غزل	gq ah z ah l
غزوہ	gq ah z v aa
غزہ	gq ah z z aa
غسل	gq uh s l
غسلخانہ	gq uh s l unk aa n aa
غش	gq ah sh
غضب	gq ah z ah b
غفلت	gq ah f l ah t
غلام	gq uh l aa m
غلطی	gq ah l ah t iy
غلہ	gq ah l l aa
غم	gq ah m
غمر	gq uh m ah unk
غنائیت	gq uh n n aa iy y ah t
غنچہ	gq uh n ch aa
غنڈہ	gq uh n dx aa
غنہ	gq uh n n ah
غور	gq ao unk
غوٹہ	gq ow tx aa
غژماں	gq uh zh m aa
غیر	gq eh unk
غیرت	gq eh unk ah t
ف	f
ف	f ey
فادر	f aa d ah unk
فارسی	f aa unk s iy
فارغ	f aa unk ih gq
فاس	f aa s
فاسد	f aa s ih d
فاصلہ	f aa s l aa
فاصلہ	f aa s ih l aa
فاضل	f aa z ih l
فاقہ	f aa q aa
فالتو	f aa l t uw
فالج	f aa l ih jh
فالحال	f ih l h aa l
فالسئی	f aa l s ah iy
فالسہ	f aa l s aa
فالودہ	f aa l uw d aa
فانوس	f aa n uw s
فانی	f aa n iy
فاکہہ	f aa k ih h aa
فتنہ	f ih t n aa
فجی	f ih jh iy
فحش	f uh h sh
فخر	f ah unk unk
فدیہ	f ih d y aa
فرات	f ah unk aa t
فرات	f uh unk aa t
فراز	f ah unk aa z
فراموش	f ah unk aa m ow sh
فرانس	f ah unk aa s
فرانس	f unk aa n s
فرانس	f unk aa s
فرانسیسی	f ah unk aa n s iy s iy
فراہم	f ah unk aa h ah m
فربہ	f ah unk b aa
فرزند	f ah unk z ah n d
فرش	f ah unk sh
فرشتہ	f ah unk ih sh t aa
فرشتہ	f ih unk ih sh t aa
فرص	f ah unk s
فرصت	f uh unk s ah t
فرض	f ah unk z
فرض	f ah unk ah z
فرضی	f ah unk z iy
فرعون	f ih unk unk ao n
فرقہ	f ih unk q aa
فرمائش	f ah unk m aa ih sh
فرمان	f ah unk m aa n
فرمانا	f ah unk m aa n aa
فرنگی	f ah unk ah n g iy
فرہنگ	f ah unk h ah ng g
فریاد	f ah unk y aa d
فریال	f ah unk y aa l
فرینکفرٹ	f unk eh ng k f ah unk tx
فزان	f ah z z aa n
فساد	f ah s aa d
فسادی	f ah s aa d iy
فسانہ	f ah s aa n aa
فضا	f ah z aa
فضائیہ	f ih z aa ih y aa
فطرت	f ih t unk ah t
فقہ	f ih q h
فقیر	f ah q iy unk
فلاں	f uh l aa
فلسطین	f ih l ih s t iy n
فلپائن	f ih l p aa ih n
فلپائن	f ih l ih p aa ih n
فلک	f ah l ah k
فلکیات	f ah l k iy y aa t
فن	f ah n
فوتگی	f ao t ah g iy
فوتگی	f ao t ih g iy
فوج	f ao jh
فورا	f ao unk ah n
فون	f ow n
فون	f uw n
فٹافٹ	f ah tx aa f ah tx
فٹافٹ	ph
فکر	f ih k unk
فیروزوالہ	f ey unk ow z ey v aa l aa
فیروزہ	f iy unk ow z aa
فیروزی	f ey unk ow z iy
فیصد	f iy s ah d
فیصل	f eh s ah l
فیصلہ	f eh s l aa
فیل	f iy l
ق	q
ق	q aa f
قاب	q aa b
قابض	q aa b ih z
قابل	q aa b ih l
قابلیت	q aa b l ih y ah t
قاتل	k aa t ah l
قاتل	q aa t ih l
قادیان	q aa d ih y aa n
قاری	q aa unk iy
قاضی	q aa z iy
قاعدہ	q aa ih d aa
قافلہ	q aa f l aa
قافلہ	q aa f ih l aa
قافیہ	q aa f ih y aa
قاقم	q aa q uh m
قالین	q aa l iy n
قاموس	q aa m uw s
قانون	q aa n uw n
قانونی	q aa n uw n iy
قاچاقی	q aa ch aa q iy
قاہرہ	q aa h ih unk aa
قبر	q ah b unk
قبرستان	q ah b unk ih s t aa n
قبرص	q ah b unk ah s
قبض	q ah b z
قبضہ	q ah b z aa
قبل	q ah b l
قبلتین	q ih b l ah t eh n
قبول	q uh b uw l
قتل	q ah t l
قدم	q ah d ah m
قدم	q ih d ah m
قدیم	q ah d iy m
قرآن	q uh unk unk aa n
قرار	q ah unk aa unk
قراقرم	q ah unk aa q uh unk ah m
قربانی	q uh unk b aa n iy
قرض	q ah unk z
قرضہ	q ah unk z aa
قرطبہ	q uh unk t uh b aa h
قرمزی	q ih unk m ih z iy
قرہ	q ah unk aa
قریب	q ah unk iy b
قزاقستان	q ah z aa q ih s t aa n
قسط	q ih s t
قسم	q ah s ah m
قسم	q ih s m
قسمت	q ih s m ah t
قشنگ	q ah sh ah ng g
قصائی	q ah s aa iy
قصاب	q ah s s aa b
قصاص	q ih s aa s
قصبات	q ah s b aa t
قصبوں	q ah s b ow
قصبہ	q ah s b aa
قصبے	q ah s b ey
قصور	q ah s uw unk
قصہ	q ih s s aa
قطار	q ih t aa unk
قطب	q uh t b
قطب	q uh t uh b
قطعی	q ah t unk iy
ققنس	q ah q n uh s
قلات	q ah l aa t
قلب	q ah l b
قلعہ	q ah l unk aa
قلعہ	q ih l aa
قلعہ	q ih l unk aa
قلم	q ah l ah m
قلندر	q ah l ah n d ah unk
قلی	q uh l iy
قمچی	q uh m ch iy
قمیص	q ah m iy s
قمیض	q ah m iy z
قواعد	q ah v aa ih d
قوت	q uw t
قوت	q uh v v ah t
قوطی	q uw t iy
قوق	q ao q
قوم	q ao m
قومی	q ao m iy
قومیت	q ao m ih y ah t
قوی	q ah v iy
قوی	q uh v aa
قہر	q ah h unk
قہقہہ	q ah h q ah h aa
قہوہ	q ah h v aa
قیادت	q ih y aa d ah t
قیامت	q ah y aa m ah t
قید	q eh d
قیمت	q iy m ah t
قیمتی	q iy m ah t iy
قیمہ	q iy m aa
قینچی	q eh ch iy
قے	q ey
كشی	k ah sh iy
ل	l
ل	l aa m
لائبریری	l aa ih b unk ey unk iy
لائٹر	l aa ih tx ah unk
لاجورد	l aa jh v ah unk d
لاجوردی	l aa jh v ah unk d iy
لازم	l aa z ih m
لال	l aa l
لالٹین	l aa l tx ey n
لالہ	l aa l aa
لامتناہی	l aa m uh t ah n aa h iy
لانڈگا	l aa dx g aa
لاوارث	l aa v aa unk ih s
لاٹھی	l aa txh iy
لاپتہ	l aa p ah t ah
لاپروا	l aa p ah unk v aa
لاڈلہ	l aa dx l aa
لاڑکانہ	l aa r k aa n aa
لاکھ	l aa kh
لاہور	l aa h ao unk
لاہور	l ah h ow unk
لاہوری	l aa h ao unk iy
لب	l ah b
لباس	l ih b aa s
لبنان	l ah b n aa n
لبنان	l ih b n aa n
لبھانا	l uh bh aa n aa
لتھوینیا	l ih th uh ey n ih y aa
لجنہ	l ah jh n aa
لجنہ	l ah jh ah n aa
لداخ	l ah d d aa unk
لدھیانہ	l uh dh ih y aa n aa
لرزاں	l ah unk z aa
لسان	l ih s aa n
لسانیات	l ih s aa n ih y aa t
لطفا	l uh t f ah n
لطیفہ	l ah t iy f aa
لعب	l ah unk b
لغت	l uh gq ah t
لغو	l ah gq v
لغوی	l uh gq ah v iy
لفافہ	l ih f aa f aa
لفظ	l ah f z
لفظ	l ah f z
لفظ	l ah v z
لفنگا	l ah f ah ng g aa
لقب	l ah q ah b
لقمان	l uh q m aa n
للاٹ	l ah l aa tx
لمبا	l ah m b aa
لمبائی	l ax m b aa iy
لمحاتی	l ah m h aa t iy
لمپٹ	l ah m p ah tx
لندن	l ah n d ah n
لنگ	l ih ng g
لنگایت	l ih ng g aa y ah t
لوبیا	l ow b ih y aa
لوتھ	l ow th
لودهراں	l ow dh unk aa
لورالائی	l ow unk aa l aa iy
لوری	l ow unk iy
لوسیل	l uw s eh l
لوط	l uw t
لوٹا	l ow tx aa
لوٹا	l uw tx aa
لوٹا	l ao tx aa
لوگ	l ow g
لوگو	l ow g ow
لوگوں	l ow g ow
لوہا	l ow h aa
لوہار	l ow h aa unk
لڑائی	l ah r aa iy
لڑنا	l ah r n aa
لڑکا	l ah r k aa
لڑکی	l ah r k iy
لکشادیپ	l ah k sh aa d iy p
لکشمی	l ah k sh m iy
لکڑی	l ah k r iy
لکھائی	l ih kh aa iy
لکھنا	l ih kh n aa
لگام	l ah g aa m
لگانا	l ah g aa n aa
لگے	l ah g ey
لہجہ	l ah h jh aa
لہذا	l ih h aa z aa
لہرانا	l eh h unk aa n aa
لہسن	l ah h s uh n
لہنگا	l eh h ng g aa
لہنگا	l eh h eh ng g aa
لہو	l ah h uw
لیئج	l ih ey jh
لیئج	l ih y ey jh
لیسٹر	l eh s tx ah unk
لیل	l iy l
لیموں	l iy m uw
لیموں	l iy m uw
لینا	l ey n aa
لیون	l ih y ow n
لیون	l ih y ao n
لیوں	l ih y ow
لیوں	l ih y ao
لیٹنا	l ey tx n aa
لیکن	l ey k ih n
لیکھ	l ey kh
لیکھنی	l ey kh ah n iy
لیکھک	l ey kh ah k
لیہہ	l ey h
م	m
م	m iy m
مؤذن	m uh ah z z ih n
مؤسسہ	m uh unk ah s s ih s aa
ماء	m aa unk
ماتا	m aa t aa
ماتم	m aa t ah m
ماتھا	m aa th aa
ماحول	m aa h ao l
مارنا	m aa unk n aa
مارونی	m aa unk uw n iy
مارگ	m aa unk g
ماسکو	m aa s k ow
ماضی	m aa z iy
مالا	m aa l aa
مالدیپ	m aa l d iy p
مالٹا	m aa l tx aa
مالک	m aa l ih k
ماما	m aa m aa
ماموں	m aa m uw
ماندہ	m aa n d aa
ماندہ	m aa d aa
مانسہرہ	m aa n s eh h unk aa
مانوس	m aa n uw s
مانچسٹر	m aa n ch ih s tx ah unk
مانگ	m aa ng g
ماہ	m aa h
ماہانہ	m aa h aa n aa
ماہر	m aa h ih unk
ماہرین	m aa h ih unk iy n
ماہی	m aa h iy
ماہ‌جبیں	m aa h jh ah b iy
مبارک	m uh b aa unk ah k
مبارک	m uh b aa unk ih k
مبلغ	m ah b l ah gq
مبلغ	m uh b l ah gq
مبلغ	m uh b ah l l ih gq
مبنی	m ah b n aa
مت	m ah t
متجسس	m uh t ah jh ah s s ih s
مترا	m ih t unk aa
مترائی	m ih t unk aa iy
مترجم	m uh t ah unk jh ih m
متسیہ	m ah t s y aa
متعارف	m uh t ah unk aa unk ah f
متعلق	m uh t ah unk ah l l ih q
متلی	m ah t l iy
متوالی	m uh t ah v aa l iy
متوجہ	m uh t ah v ah d jh
متولد	m uh t ah v ah l l ih d
متولی	m uh t ah v ah l l iy
متھرا	m ah th uh unk aa
مثال	m ih s aa l
مثلا	m ah s ah l ah n
مجبور	m ah jh b uw unk
مجرم	m uh jh unk ih m
مجھ	m uh jh
مجھے	m ih jh ey
مجھے	m uh jh ey
مجہول	m ah jh h uw l
محاسب	m uh h aa s ih b
محافظ	m uh h aa f ih z
محافظت	m uh h aa f ah z ah t
محبت	m ow h ah b b ah t
محبت	m uh h ah b b ah t
محتسب	m ow h t ah s ih b
محراب	m ey h unk aa b
محراب	m ih h unk aa b
محروم	m ah h unk uw m
محسوس	m ah h s uw s
محشر	m ah h sh ah unk
محفل	m ah h f ih l
محل	m ah h ah l
محل	m eh h eh l
محلہ	m ow h ah l l aa
محلہ	m ah h ah l l aa
محلہ	m uh h ah l l aa
محمد	m ow h ah m m ah d
محمد	m uh h ah m m ah d
محمدی	m uh h ah m ah d iy
محنت	m ey h n ah t
محنت	m ih h n ah t
مختصر	m uh unk t ah s ah unk
مختصرا	m uh unk t ah s ah unk ah n
مختلف	m uh unk t ah l ah f
مختلف	m uh unk t ah l ih f
مخدوم	m ah unk d uw m
مخزن	m ah unk z ah n
مخلوط	m ah unk l uw t
مخمل	m ah unk m ah l
مخملی	m ah unk m ah l iy
مدت	m uh d d ah t
مدد	m ah d ah d
مددگار	m ah d ah d g aa unk
مدرا	m uh d ah unk aa
مدعی	m uh d d ah unk aa
مدعی	m uh d ah unk iy
مدھم	m ah dh ah m
مدیر	m uh d iy unk
مدیرا	m ah d iy unk aa
مدینہ	m ah d iy n aa
مذاق	m ah z aa q
مذمت	m ah z ah m m ah t
مذکر	m uh z ah k k ah unk
مذہب	m ah z h ah b
مذہبی	m ah z h ah b iy
مراٹھی	m ah unk aa txh iy
مراکش	m ah unk aa k ih sh
مربا	m uh unk ah b b aa
مربع	m uh unk ah b b aa unk
مرتبہ	m ah unk t ah b aa
مرتیو	m unk ih t y uw
مرد	m ah unk d
مردار	m uh unk d aa unk
مردان	m ah unk d aa n
مردانگی	m ih unk d aa ng g iy
مردانہ	m ah unk d aa n aa
مردنی	m ah unk d ah n iy
مردنی	m uh unk d ah n iy
مرض	m ah unk z
مرعش	m ah unk unk ah sh
مرغابی	m uh unk gq aa b iy
مرغی	m uh unk gq iy
مرمت	m ah unk ah m ah t
مرنا	m ah unk n aa
مروانا	m ah unk v aa n aa
مرکز	m ah unk k ah z
مرکزی	m ah unk k ah z iy
مریدکے	m uh unk iy d k ey
مریض	m ah unk iy z
مریم	m ah unk y ah m
مزاج	m ih z aa jh
مزاحمت	m uh z aa h ah m ah t
مزدور	m uh z d uw unk
مزور	m ah z uw unk
مزہ	m ah z ah
مزید	m ah z iy d
مزیدار	m ah z ey d aa unk
مسئلہ	m ah s l aa
مسئلہ	m ah s ah l aa
مسئلہ	m ah s unk ah l aa
مسافر	m uh s aa f ih unk
مستراح	m uh s t ah unk aa h
مسترد	m uh s t ah unk ah d
مستعفی	m uh s t ah unk f iy
مستقبل	m uh s t ah q b ih l
مستقر	m uh s t ah q ah unk
مستونگ	m ah s t uw ng g
مسجد	m ah s jh ih d
مسقط	m ah s q ah t
مسلسل	m uh s ah l s ah l
مسلمان	m uh s ah l m aa n
مسلمہ	m uh s ah l l ah m aa
مسود	m uh s ah v v ah d
مسیح	m ah s iy h
مسیحا	m ah s iy h aa
مسیحی	m ah s iy h iy
مسیحیت	m ah s iy h ih y ah t
مشترکہ	m uh sh t ah unk k aa
مشترکہ	m uh sh t ah unk ah k aa
مشرق	m ah sh unk ih q
مشرک	m uh sh unk ih k
مشعل	m ah sh unk ah l
مشغلہ	m ah sh gq ah l aa
مشغول	m ah sh gq uw l
مشق	m ah sh q
مشقت	m ah sh ah q ah t
مشوروں	m ah sh v ah unk ow
مشورہ	m ah sh w ah unk aa
مشورہ	m ah sh v ah unk aa
مشورے	m ah sh v ah unk ey
مشک	m uh sh k
مشکل	m uh sh k ih l
مشہد	m ah sh h ah d
مشہور	m ah sh h uw unk
مشہوری	m ah sh h uw unk iy
مصالحہ	m ah s aa l aa
مصالحہ	m ah s aa l h aa
مصالحہ	m ah s aa l ih h aa
مصر	m ih s ah unk
مصر	m ih s unk
مصروف	m ah s unk uw f
مصری	m ih s unk iy
مصنف	m uh s ah n n ih f
مصیبت	m uh s iy b ah t
مضموم	m ah z m uw m
مضمون	m ah z m uw n
مطالعہ	m uh t aa l ah unk aa
مطعم	m ah t unk ah m
مطلب	m ah t l ah b
مطلقا	m uh t l ah q ah n
مظاہرہ	m uh z aa h ih unk aa
مظاہرین	m uh z aa h ih unk iy n
مظلوم	m ah z l uw m
مع	m ah unk
معاش	m ah unk aa sh
معاشرہ	m uh unk aa sh ih unk aa
معاصر	m uh unk aa s ah unk
معاملہ	m aa m l aa
معاملہ	m uh aa m l aa
معاہدہ	m uh unk aa h ah d aa
معبد	m ah unk b ah d
معبد	m ah ai b ah d
معبود	m aa unk b uw d
معتمد	m ow unk t ah m ah d
معجزہ	m ow ih z aa h
معجزہ	m ow unk jh ih z aa h
معذرت	m aa unk z ah unk ah t
معذور	m ah ai z uw unk
معروف	m ah ai unk uw f
معرکہ	m ah unk unk ah k aa
معطل	m uh unk ah t t ah l
معلم	m uh unk ah l l ah m
معلم	m uh unk ah l l ih m
معلوم	m ah ai l uw m
معمار	m ey unk m aa unk
معماری	m ey unk m aa unk iy
معمر	m uh unk m ah unk
معمر	m uh unk ah m ah unk
معمول	m ah unk m uw l
معیار	m ih unk y aa unk
معیار	m ih ai y aa unk
معیاری	m ey unk y aa unk iy
معیشت	m ah unk iy sh ah t
مغل	m uh gq ah l
مغلوط	m ah gq l uw t
مفاہمت	m uh f aa h ih m ah t
مفت	m uh f t
مفتوح	m ah f t uw h
مفتی	m uh f t iy
مفہوم	m ah f h uw m
مقامی	m ah q aa m iy
مقامی	m uh q aa m iy
مقبوض	m ah q b uw z
مقبوضہ	m ah q b uw z aa
مقبول	m ah q b uw l
مقتل	m ah q t ah l
مقدار	m ih q d aa unk
مقدسہ	m uh q ah d ah s aa
مقدونی	m ah q d uw n iy
مقصد	m ah q s ah d
مقناطيس	m ah q n aa t iy s
مقناطيس	m ih q n aa t iy s
مقناطیس	m ah q n aa t iy s
مقناطیس	m ih q n aa t iy s
مقیم	m uh q iy m
ملائیشیا	m ah l ah y sh ih y aa
ملاحظہ	m uh l aa h ah z aa
ملازمت	m uh l aa z m ah t
ملازمت	m uh l aa z ah m ah t
ملاقات	m uh l aa q aa t
ملامت	m ah l aa m ah t
ملانا	m ih l aa n aa
ملتان	m uh l t aa n
ملتانی	m uh l t aa n iy
ملزم	m uh l z ih m
ململ	m ah l m ah l
ملن	m ah l ih n
ملن	m ih l ah n
ملنا	m ah l n aa
ملنا	m ih l n aa
ملنسار	m ih l ah n s aa unk
ملنگ	m ah l ah ng g
ملوث	m uh l ah v v ah s
ملک	m uh l k
ملک	m uh l ah k
ملکہ	m ah l k aa
ملکہ	m ah l ih k aa
ملی	m ah l l iy
ملی	m ih l l iy
ملیامیٹ	m ah l ih y aa m ey tx
ملیامیٹ	m ih l ih y aa m ey tx
ممالک	m ah m aa l ih k
ممبئی	m uh m b ah iy
ممباسہ	m uh m b aa s aa
مملکت	m ah m l uh k ah t
ممنوع	m ah m n uw
ممکن	m uh m k ih n
مناسب	m uh n aa s ih b
مناسبت	m uh n aa s ah b ah t
مناظر	m ah n aa z ih unk
منانا	m ah n aa n aa
منتخب	m uh n t ah unk ah b
منتر	m ah n t ah unk
منتظم	m uh n t ah z ih m
منحوس	m ah n h uw s
مندر	m ah n d ih unk
منزل	m ah n z ih l
منسلک	m uh n s ah l ih k
منسوخ	m ah n s uw unk
منشور	m ah n sh uw unk
منشی	m uh n ah sh sh iy
منشی	m uh n sh iy
منشیات	m uh n ah sh ih y aa t
منشیہ	m ah n uh sh y ah
منصوبہ	m ah n s uw b aa
منظر	m ah n z ah unk
منظم	m uh n ah z ah m
منظور	m ah n z uw unk
منع	m ah n aa
منع	m ah n ah unk
منقطع	m uh n q ah t ey unk
منٹ	m ih n ah tx
منڈا	m uh n dx aa
منکر	m uh n k ah unk
منگنی	m ah ng g n iy
منگوانا	m ah ng g v aa n aa
منگوانا	m ah g v aa n aa
منگیتر	m ah ng g ey t ah unk
منہ	m uw h
منی	m ah n iy
منیت	m uh n iy y ah t
منیت	m uh n y ah t
مواصلات	m ow aa s ah l aa t
مواصلات	m uh aa s ah l aa t
مواصلات	m uh v aa s ah l aa t
مواقع	m ah v aa q ey
موج	m ao jh
موجود	m ao jh uw d
موجود	m ah jh uw d
موجودگی	m ao jh uw d ah g iy
موجودگی	m ao jh uw d g iy
موجودہ	m ao jh uw d aa
مورت	m uw unk ah t
مورتی	m uw unk t iy
مورمن	m ao unk m ah n
موز	m ao z
موزمبیق	m ow z aa m b iy q
موسم	m ao s ah m
موسوم	m ao s uw m
موسی	m uw s aa
موسیقار	m uw s iy q aa unk
موسیقی	m uw s iy q iy
موضوع	m ao z uw unk
موقع	m ao q aa
مول	m uw l
مولا	m ao l aa
مولود	m ao l uw d
مومن	m ow m ih n
مونٹینیگرو	m ow n tx ey n iy g unk ow
موٹا	m ow tx aa
موٹی	m ow tx iy
مویشی	m ah v ey sh iy
مٹانا	m ih tx aa n aa
مٹنا	m ih tx n aa
مٹھی	m uh tx txh iy
مچھ	m ah t ch
مچھر	m ah ch ah unk
مچھلی	m ah ch l iy
مژگانی	m ih zh g aa n iy
مکان	m ah k aa n
مکتب	m ah k t ah b
مکروہ	m ah k unk uw h
مکسور	m ah k s uw unk
مکھ	m uh kh
مکھن	m ah k kh ah n
مکھڑا	m uh kh r aa
مکہ	m ah k ah
مگرمچھ	m ah g ah unk m ah ch
مہابھارت	m ah h aa bh aa unk ah t
مہاجر	m ow h aa jh ih unk
مہاجر	m uh h aa jh ih unk
مہاجرت	m ow h aa jh ah unk ah t
مہاجرت	m uh h aa jh ah unk ah t
مہاجرین	m ow h aa jh ih unk iy n
مہاجرین	m uh h aa jh ih unk iy n
مہاراشٹر	m ah h aa unk aa sh tx ah unk
مہاراشٹر	m ah h aa unk aa sh tx unk aa
مہارانی	m ah h aa unk aa n iy
مہارت	m ah h aa unk ah t
مہان	m ah h aa n
مہاوت	m ah h aa v ah t
مہر	m ey h ah unk
مہر	m ow h ah unk
مہر	m ih h ah unk
مہر	m uh h ah unk
مہران	m ey h unk aa n
مہران	m ih h unk aa n
مہربان	m ey h unk b aa n
مہربان	m ih h unk b aa n
مہمان	m ey h m aa n
مہمان	m ey h m aa
مہمان	m ih h m aa n
مہمانی	m ih h m aa n iy
مہندس	m uh h ah n d ih s
مہندی	m ey h ah n d iy
مہندی	m ey h ax d iy
مہندی	m ih h ah n d iy
مہندی	m ih h ax d iy
مہنڈر	m ih h ih n dx ah unk
مہنگا	m ah h ah ng g aa
مہنگا	m ah h ax g aa
مہنگائی	m ah h ah ng g aa iy
مہیلا	m ah h iy l aa
مہینا	m ah h iy n aa
مہینہ	m ah h iy n aa
میانمار	m ih y aa n m aa unk
میانوالی	m ih y aa v aa l iy
میاں	m ih y aa
میتھن	m eh th uh n
میدان	m eh d aa n
میرا	m ey unk aa
میرپور	m iy unk p uw unk
میز	m ey z
میزان	m iy z aa n
میزبان	m ey z b aa n
میزورم	m iy z ow unk ah m
میغ	m ey gq
میغ	m iy gq
میل	m iy l
مینو	m iy n uw
مینڈھر	m ey n dxh ah unk
مینڈھک	m ey n dxh ah k
مینگورہ	m iy ng g ow unk aa
مینہ	m eh h
میور	m ah y uw unk
میونخ	m y uw n ih unk
میوہ	m ey v aa
میٹھا	m iy txh aa
میکائیل	m iy k aa iy l
میکسیکو	m ey k s iy k ow
میگھ	m ey g
میگھالیہ	m ey g aa l ih y ah h
میں	m eh
میں	m eh
مے	m eh
ن	n
ن	n uw n
ن	ng
ن	n
ن	n
نئی	n ah iy
نا	n aa
نائی	n aa iy
نائیجیریا	n aa iy jh iy unk ih y aa
ناخدا	n aa unk uh d aa
ناخن	n aa unk uh n
نادان	n aa d aa n
ناراض	n aa unk aa z
نارنجی	n aa unk ah n jh iy
نارنگی	n aa unk ah ng g iy
نارووال	n aa unk ow v aa l
ناروے	n aa unk v ey
ناز	n aa z
نازل	n aa z ih l
نازک	n aa z uh k
ناستک	n aa s t ih k
ناشتا	n aa sh t aa
ناشر	n aa sh ih unk
ناصر	n aa s ih unk
ناصرت	n aa s ah unk ah t
ناصرہ	n aa s ih unk aa
ناظر	n aa z ih unk
ناظم	n aa z ih m
ناف	n aa f
نافرمان	n aa f ah unk m aa n
نافرمانبرداری	n aa f ah unk m aa b ah unk d aa unk iy
ناقوس	n aa q uw s
نال	n aa l
نالی	n aa l iy
نام	n aa m
ناممکن	n aa m uh m k ih n
نامہ	n aa m aa
نامی	n aa m iy
نان	n aa n
نانا	n aa n aa
نانگل	n aa ng g ah l
نانی	n aa n iy
ناچ	n aa ch
ناچنا	n aa ch n aa
ناک	n aa k
ناکام	n aa k aa m
ناگ	n aa g
ناگالینڈ	n aa g aa l eh n dx
ناگرک	n aa g unk ih k
ناہر	n aa h ah unk
نایاب	n aa y aa b
نباتیات	n ah b aa t ih y aa t
نبض	n ah b z
نبھانا	n ih bh aa n aa
نتیجتا	n ah t iy jh ah t ah n
نتیجہ	n ah t iy jh aa
نثر	n ah s unk
نجبا	n uh jh ah b aa
نجی	n ih jh iy
نجیب	n ah jh iy b
نخرا	n ah unk unk aa
نخست	n uh unk uh s t
نخچیر	n ah unk ch iy unk
ندرشن	n ih d ah unk sh ah n
ندی	n ah d iy
ندیاں	n ah d ih y aa
ندیو	n ah d ih y ow
ندیوں	n ah d ih y ow
نر	n ah unk
نردوش	n ih unk d ow sh
نرمان	n ih unk m aa n
نرنایک	n ih unk n aa y ah k
نرگس	n ah unk g ih s
نزاکت	n ah z aa k ah t
نزدیکی	n ah z d iy k iy
نزہت	n uh z h ah t
نساء	n ih s aa unk
نسبتا	n ih s b ah t ah n
نستعلیق	n ah s t aa l iy q
نسخ	n ah s unk
نسخہ	n uh s unk aa
نسل	n ah s l
نشان	n ih sh aa n
نشانی	n ih sh aa n iy
نشریات	n ah sh unk ih y aa t
نشریہ	n ah sh unk ih y ah
نشست	n ah sh ih s t
نشور	n uh sh uw unk
نشچت	n ih sh ch ih t
نصاب	n ih s aa b
نصاری	n ah s aa unk aa
نصرانی	n ah s unk aa n iy
نصرت	n uh s unk ah t
نصیب	n ah s iy b
نظارہ	n ah z aa unk aa
نظام	n ih z aa m
نظامت	n ih z aa m ah t
نظر	n ah z ah unk
نظریہ	n ah z ah unk ih y aa
نظم	n ah z m
نظم	n ah z ah m
نظیف	n ah z iy f
نعت	n aa t
نعرہ	n aa unk aa h
نعمت	n ey m ah t
نعمت	n ih unk m ah t
نغمہ	n ah gq m aa
نفاذ	n ah f aa z
نفاق	n ah f aa q
نفرت	n ah f unk ah t
نقاب	n ah q aa b
نقاب	n ih q aa b
نقصان	n uh q s aa n
نقطہ	n uh q t aa
نقلی	n ah q l iy
نماز	n ah m aa z
نماز	n ih m aa z
نمبو	n ih m b uw
نمستے	n ah m ah s t ey
نمونہ	n ah m uw n
نمک	n ah m ah k
نمکین	n ah m k iy n
نمی	n ah m iy
نن	n ah n
ننگا	n ax ng g aa
ننھا	n ah n n h aa
نو	n ao
نوآبادیاتی	n ao aa b aa d ih y aa t iy
نوابشاہ	n ah v aa b sh aa h
نوبت	n ao b ah t
نوح	n uw h
نور	n uw unk
نوش	n ow sh
نوشکی	n uw sh k iy
نوشہرہ	n ao sh eh h unk aa
نوشی	n ow sh iy
نوواں	n ax uw v aa
نوکر	n ao k ah unk
نوکرانی	n ao k unk aa n iy
نوکری	n ao k unk iy
نوید	n ah v ey d
نوید	n ah v iy d
نویدن	n ih v ey d ah n
نویس	n ah v iy s
نویسندہ	n ah v iy s ah n d aa
نویسندہ	n ah v iy s ih n d aa
نيت	n iy t
نپولین	n ah p ow l ih y ah n
نژاد	n ah zh aa d
نژاد	n ih zh aa d
نکاح	n ih k aa h
نکاراتمک	n ah k aa unk aa t m ah k
نکالنا	n ih k aa l n aa
نکسیر	n ah k s iy unk
نکما	n ih k ah m m aa
نگاہ	n ih g aa h
نگر	n ah g ah unk
نگرانی	n ih g unk aa n iy
نہ	n aa
نہ	n ah
نہاد	n ih h aa d
نہایت	n ih hh aa y ah t
نہضت	n ah h z ah t
نہیں	n ah h iy
نیا	n ah y aa
نیر	n iy unk
نیز	n iy z
نیم	n ey m
نیم	n iy m
نیم	n ih y ah m
نین	n eh n
نیند	n iy n d
نیوجن	n ih y ow jh ah n
نیپال	n ey p aa l
نیک	n ey k
نے	n ey
و	ow
و	uw
و	ao
و	v
و	v aa v
و	v ah
وا	v aa
وابستگی	v aa b ah s t ah g iy
واحد	v aa h ih d
وادی	v aa d iy
وار	v aa unk
وارانسی	v aa unk aa n s iy
وارد	v aa unk ih d
واسط	v aa s ih t
واسطہ	v aa s ih t aa
واسع	v aa s ey unk
واسی	v aa s iy
واشک	v aa sh uh k
واقعات	v aa q ih unk aa t
واقعہ	v aa q ih unk aa
واقف	v aa q ih f
والد	v aa l ih d
والدہ	v aa l ih d aa
والدین	v aa l d eh n
والدین	v aa l ih d eh n
وامن	v aa m ah n
واپس	v aa p ah s
واکیہ	v aa k y
واہ	v aa h
واہک	v aa h ah k
وبھاجن	v ih bh aa jh ah n
وبھاگ	v ih bh aa g
وتر	v ah t ah unk
وتر	v ih t unk
ودھان	v ih dh aa n
ودھوا	v ih dh v aa
ودیارتھی	v ih d y aa unk th iy
ورزش	v ah unk z ih sh
ورودھ	v ih unk ow dh
وزارت	v ih z aa unk ah t
وزرا	v uh z ah unk aa
وزیر	v ah z iy unk
وستو	v ah s t uw
وسنت	v ah s ah n t
وشنو	v ih sh n uw
وصال	v ih s aa l
وضو	v ah z uw
وضو	v uh z uw
وفا	v ah f aa
وفاق	w ah f aa q
وفاق	w ih f aa q
وفد	v ah f d
وفد	v ah f ah d
وقار	v ah q aa unk
وقف	v ah q f
وقوع	v uh q uw unk
ولایت	v ih l aa y ah t
ولایتی	v ih l aa y ah t iy
ولد	v ah l ah d
ولندیز	v ah l ah n d ey z
ولی	v ah l iy
ونا	v ih n aa
وندر	v ih n d ah unk
ونشج	v ah n sh ah jh
وواد	v ih v aa d
وچن	v ah ch ah n
وڈھ	v ah dxh
وکھیات	v ih kh y aa t
وگیان	v ih g y aa n
وہ	v ow
وہاڑی	v ih h aa r iy
وہاں	v ah h aa
وہی	v ah h iy
ویتنام	v iy y ah t n aa m
ویر	v iy unk
ویران	v iy unk aa n
وینجن	v y ah n jh ah n
وینیزویلا	v eh n iy z v eh l aa
ویژن	v iy zh ah n
وے	v ey
ٹ	tx
ٹ	tx ey
ٹالنا	tx aa l n aa
ٹانگ	tx aa ng g
ٹاپو	tx aa p uw
ٹرام	tx unk aa m
ٹرو	tx ah unk unk uw
ٹرک	tx unk ah k
ٹریکٹر	tx ah unk eh k tx ah unk
ٹریکٹر	tx unk eh k tx ah unk
ٹلفورڈ	tx ih l f ow unk dx
ٹماٹر	tx ah m aa tx ah unk
ٹوٹا	tx uw tx aa
ٹوٹنا	tx uw tx n aa
ٹوٹی	tx uw tx iy
ٹوپی	tx ow p iy
ٹٹی	tx ah tx tx iy
ٹکر	tx ah k k ah unk
ٹکراو	tx ah k unk aa v
ٹکٹ	tx ih k ah tx
ٹھرکی	txh ah unk k iy
ٹھنڈا	txh ah n dx aa
ٹھوس	txh ow s
ٹھوڑی	txh ow r iy
ٹھڈی	txh uh dx dx iy
ٹھکانا	txh ih k aa n aa
ٹھہرنا	txh ah h ah unk n aa
ٹھہرنا	txh eh h eh unk n aa
ٹھیلا	txh ey l aa
ٹھیکا	txh ey k aa
ٹھیکیدار	txh ey k ey d aa unk
ٹینگی	tx eh g iy
ٹیپ	tx ey p
ٹیکسلا	tx eh k s ih l aa
ٹیکسی	tx eh k s iy
پ	p
پ	p ey
پاؤں	p aa uw
پاؤں	p aa uw
پائپ	p aa ih p
پاد	p aa d
پادری	p aa d unk iy
پارسی	p aa unk s iy
پارچہ	p aa unk ch aa
پاسبان	p aa s b aa n
پاستا	p aa s t aa
پاسپورٹ	p aa s p ow unk tx
پال	p aa l
پالتو	p aa l t uw
پالم	p aa l ah m
پالنا	p aa l n aa
پالک	p aa l ah k
پان	p aa n
پانا	p aa n aa
پانو	p aa ow
پانو	p aa v
پانچ	p aa ch
پانچواں	p aa ch v aa
پانڈو	p aa n dx ah v
پانہ	p aa n aa
پانی	p aa n iy
پاٹھک	p aa txh ah k
پاپ	p aa p
پاکستان	p aa k ih s t aa n
پاکستانی	p aa k ih s t aa n iy
پاکپتن	p aa k p ah t t ah n
پتا	p ah t aa
پتا	p ih t aa
پتری	p uh t unk iy
پتلون	p ah t l uw n
پتنگ	p ah t ah ng g
پتنی	p ah t n iy
پتھر	p ah t th ah unk
پتہ	p ah t aa
پتی	p ah t iy
پتی	p ah t t iy
پد	p ah d
پدر	p ih d ah unk
پذیر	p ah z iy unk
پر	p ah unk
پراتن	p uh unk aa t ah n
پرانت	p unk aa n t
پراٹھا	p ah unk aa txh aa
پراپت	p unk aa p t
پراچین	p unk aa ch iy n
پراکرت	p unk aa k unk ih t
پربھات	p unk ah bh aa t
پرتگال	p uh unk t ah g aa l
پرتگال	p uh unk t uh g aa l
پرتگیا	p unk ah t ih g y aa
پردوں	p ah unk d ow
پردہ	p ah unk d aa
پردیش	p unk ah d ey sh
پردے	p ah unk d ey
پرزہ	p uh unk z aa
پرستان	p ah unk ih s t aa n
پرستش	p ah unk ah s t ih sh
پرسوں	p ah unk s ow
پرش	p ah unk uh sh
پرش	p uh unk uh sh
پرشنسا	p unk ah sh ah n s aa
پرشیا	p ah unk sh ih y aa
پرمکھ	p unk ah m uh kh
پرمیشور	p ah unk m ey sh v ah unk
پرمیشور	p ah unk ah m ey sh v ah unk
پرندہ	p ah unk ah n d ah
پرندہ	p ah unk ih n d ah
پرنی	p ah unk n iy
پروا	p ah unk v aa
پروار	p ah unk ih v aa unk
پروت	p ah unk v ah t
پروردگار	p ah unk w ah unk d ih g aa unk
پروردگار	p ah unk v ah unk d ih g aa unk
پرورش	p ah unk v ah unk ih sh
پرول	p ah unk v ah l
پرونا	p ih unk ow n aa
پرچار	p ah unk ch aa unk
پرچم	p ah unk ch ah m
پرچہ	p ah unk ch aa
پرچہ	p ah unk ch ah
پرچی	p ah unk ch iy
پرکاش	p unk ah k aa sh
پرکاشک	p ah unk k aa sh ah k
پرکھ	p uh unk uh kh
پرکھیات	p unk ah kh y aa t
پری	p ah unk iy
پریت	p ah unk ey t
پریت	p ah unk iy t
پریت	p unk ey t
پریشان	p ah unk ey sh aa n
پریم	p ah unk ey m
پریم	p unk ey m
پریڈ	p ah unk eh dx
پریکشا	p ah unk iy k sh aa
پریکشائیں	p ah unk iy k sh aa eh
پستان	p ih s t aa n
پستک	p uh s t ah k
پستہ	p ih s t aa
پسر	p ih s ah unk
پسند	p ah s ah n d
پسنی	p ah s n iy
پسو	p ah s uw
پسو	p ih s s uw
پسینہ	p ah s iy n aa
پشاور	p ih sh aa v ah unk
پشتو	p ah sh t ow
پشپ	p uh sh p
پشچم	p ah sh ch ih m
پشین	p ih sh iy n
پل	p ah l
پل	p uh l
پلانڈو	p ah l aa n dx uw
پلنگ	p ah l ah ng g
پلٹنا	p ah l ah tx n aa
پنا	p ah n n aa
پناہ	p ah n aa h
پنجاب	p ah n jh aa b
پنجابی	p ah n jh aa b iy
پنجہ	p ah n jh aa
پنسل	p ey n s ih l
پنسل	p ih n s ih l
پنچھی	p ah n ch iy
پنڈال	p ih n dx aa l
پنکھ	p ah ng kh
پنکھا	p ah ng kh aa
پنکھڑی	p ah ng kh uh r iy
پنگھٹ	p ax g ah tx
پنیر	p ah n iy unk
پنیہ	p ah n y aa
پنیہ	p uh n y aa
پوت	p uw t
پوجا	p uw jh aa
پوجنا	p uw jh n aa
پوجک	p uw jh ah k
پور	p uw unk
پورا	p uw unk aa
پوربی	p uw unk b iy
پوست	p ow s t
پوشاک	p ow sh aa k
پولس	p uw l ih s
پولس	p ao l uh s
پولینڈ	p ow l eh n dx
پون	p ah v ah n
پونچھ	p uw ch
پوپ	p ow p
پوپ	p ao p
پوچھنا	p uw ch n aa
پٹاخا	p ah tx aa unk aa
پٹل	p ah tx ah l
پٹواری	p ah tx w aa unk iy
پٹواری	p ah tx v aa unk iy
پٹول	p ah tx ow l
پٹھان	p ah txh aa n
پٹی	p ah tx tx iy
پپاسا	p ih p aa s aa
پچھتر	p ah ch ah t ah unk
پچھواڑا	p ih ch v aa r aa
پڑوسی	p ah r ow s iy
پڑھائی	p ah r aa iy
پڑھنا	p ah r n aa
پژمردگی	p ah zh m uh unk d ah g iy
پژوہش	p ih zh ow h ih sh
پکا	p ah k aa
پکار	p uh k aa unk
پکنا	p ah k n aa
پھانسی	ph aa s iy
پھدی	ph uh d d iy
پھریرے	ph ah unk eh unk ey
پھل	ph ah l
پھلنا	ph ah l n aa
پھول	ph uw l
پھوپھا	ph uw ph aa
پھوڑا	ph ow r aa
پھیرا	ph ey unk aa
پھیلاو	ph eh l aa v
پھینکنا	ph eh k n aa
پھینکنا	ph eh k n aa
پہ	p ey
پہاڑ	p ah h aa r
پہلا	p ah h l aa
پہلوان	p ah h l w ah n
پہنچنا	p ah h ow ch n aa
پہنچنا	p ah h uh ch n aa
پہچان	p ah h ch aa n
پہیا	p ah h ih y aa
پہیا	p ah y y aa
پیادہ	p y aa d aa
پیار	p y aa unk
پیار	p ih y aa unk
پیارا	p y aa unk aa
پیاز	p ih y aa z
پیاس	p y aa s
پیج	p eh jh
پیدا	p eh d aa
پیدائش	p eh d aa ih sh
پیر	p iy unk
پیر	p eh unk
پیرس	p eh unk ih s
پیرو	p iy unk uw
پیرو	p eh unk uw
پیروی	p eh unk ah v iy
پیش	p ey sh
پیشاب	p ey sh aa b
پیشگوئی	p ey sh g ow y iy
پیغام	p eh gq aa m
پیغمبر	p eh gq ah m b ah unk
پیمان	p eh m aa n
پینا	p iy n aa
پینسل	p ey n s ih l
پیٹ	p ey tx
پیڑ	p ey r
چ	ch
چ	ch ey
چا	ch aa
چائے	ch aa ey
چابھی	ch aa bh iy
چابی	ch aa b iy
چادر	ch aa d ah unk
چار	ch aa unk
چارسدہ	ch aa unk s ah d aa
چاشت	ch aa sh t
چاشنی	ch aa sh n iy
چاق	ch aa q
چاقو	ch aa q uw
چال	ch aa l
چالک	ch aa l ah k
چاند	ch aa n d
چاند	ch aa d
چاندی	ch aa n d iy
چاندی	ch aa d iy
چانٹا	ch aa tx aa
چاول	ch aa v ah l
چاٹ	ch aa tx
چاٹنا	ch aa tx n aa
چاٹگام	ch aa tx g aa m
چاک	ch aa k
چاہت	ch aa h ah t
چاہنا	ch aa h n aa
چاہے	ch aa h ey
چای	ch aa y
چتکان	ch ih t k aa n
چراغ	ch ah unk aa gq
چراغ	ch ih unk aa gq
چراک	ch ah unk aa k
چربی	ch ah unk b iy
چرخہ	ch ah unk unk aa
چرس	ch ah unk ah s
چرپرا	ch ah unk p ah unk aa
چرچ	ch ah unk ch
چشتیاں	ch ih sh t ih y aa
چشم	ch ah sh m
چشمک	ch ah sh m ah k
چشمہ	ch ah sh m aa
چغتائی	ch uh gq t aa iy
چفتی	ch ah f t iy
چق	ch ih q
چقماق	ch ah q m aa q
چقمق	ch ah q m ah q
چكی	ch ah k iy
چلاس	ch ih l aa s
چلانا	ch ah l aa n aa
چلانا	ch ih l l aa n aa
چلاہٹ	ch ih l l aa h ah t
چلن	ch ah l ah n
چلنا	ch ah l n aa
چلون	ch ih l v ah n
چلچتر	ch ah l ch ih t unk ah
چماٹ	ch ah m aa tx
چمن	ch ah m ah n
چمو	ch ah m uw
چمچ	ch ah m m ah ch
چمچہ	ch ah m ch aa
چمکار	ch ah m k aa unk
چنئی	ch ah n ah iy
چناب	ch ah n aa b
چنتا	ch ih n t aa
چندر	ch ah n d r
چندربند	ch ah n d ah unk ah b ih n d uh
چنگال	ch ah ng g aa l
چنیوٹ	ch ih n ih y ow tx
چوبے	ch ao b ey
چوت	ch uw t
چوتر	ch uw t ah unk
چوتڑ	ch uw t ah r
چوتھا	ch ao th aa
چوتھائی	ch ao th aa iy
چود	ch ow d
چودنا	ch ow d n aa
چودہ	ch ao d aa
چودہ	ch ao d ah h
چور	ch ow unk
چورنگی	ch ao unk ah ng g iy
چوری	ch ow unk iy
چول	ch uw l
چولھا	ch uw l aa
چولھا	ch uw l h aa
چومنا	ch uw m n aa
چونا	ch uw n aa
چوٹ	ch ow tx
چوپان	ch ow p aa n
چوپان	ch uw p aa n
چوپان	ch ao p aa n
چوڑا	ch ao r aa
چوڑائی	ch ao r aa iy
چوڑی	ch uw r iy
چوک	ch ao k
چوکی	ch ao k iy
چوکیدار	ch ao k iy d aa unk
چوگنا	ch ao g uh n aa
چوہا	ch uw h aa
چٹکی	ch ih tx k iy
چٹکی	ch uh tx k iy
چٹگاؤں	ch ah tx g aa ow
چپ	ch uh p
چپاتی	ch ah p aa t iy
چپقلش	ch ah p q uh l ah sh
چپل	ch ah p ah l
چپٹی	ch ah p tx iy
چچی	ch ah ch iy
چڑھانا	ch ah r aa n aa
چڑھنا	ch ah r n aa
چڑیا	ch ih r ih y aa
چڑیل	ch uh r ey l
چڑیل	ch uh r eh l
چکت	ch ah k ih t
چکمہ	ch ah k m aa
چکنا	ch ah k n aa
چکنا	ch ih k n aa
چکنا	ch uh k n aa
چکنگنیا	ch ih k ah n g uh n ih y aa
چکوال	ch ah k v aa l
چکھنا	ch ah kh n aa
چگونہ	ch ih g uw n aa
چھ	ch
چھاؤنی	ch aa uh n iy
چھاؤں	ch aa ow
چھاتر	ch aa t ah unk
چھال	ch aa l
چھاپنا	ch aa p n aa
چھاپہ	ch aa p aa
چھایا	ch aa y aa
چھت	ch ah t
چھتری	ch ah t unk iy
چھلانگ	ch ah l aa ng g
چھلکا	ch ih l k aa
چھوارے	ch uh v aa unk ey
چھونا	ch uw n aa
چھوٹ	ch uw tx
چھوٹا	ch ow tx aa
چھوٹنا	ch uw tx n aa
چھٹا	ch ah tx aa
چھٹا	ch uh tx tx aa
چھٹپٹانا	ch ah tx p ah tx aa n aa
چھٹی	ch uh tx iy
چھپانا	ch uh p aa n aa
چھپنا	ch ah p n aa
چھپکلی	ch ih p k ah l iy
چھڑکاؤ	ch ih unk k aa ow
چھکا	ch ah k k aa
چھہ	ch eh h
چھینک	ch iy k
چہارم	ch ah h aa unk uh m
چہرہ	ch ey h unk aa
چہرہ	ch ih h unk aa
چیخ	ch iy unk
چیز	ch iy z
چیل	ch iy l
چیلینجی	ch iy l l iy n jh iy
چین	ch ey n
چین	ch iy n
چین	ch eh n
چینٹی	ch iy n tx iy
چینٹی	ch iy tx iy
چینی	ch iy n iy
چیونٹی	ch y uw tx iy
چیونٹی	ch ih y uw tx iy
چیچنیا	ch ey ch ah n y aa
چیچنیا	ch iy ch ah n y aa
ڈ	dx
ڈ	dx aa l
ڈالنا	dx aa l n aa
ڈاڈو	dx aa dx uw
ڈاک	dx aa k
ڈاکو	dx aa k uw
ڈاکٹر	dx aa k tx ah unk
ڈاکیہ	dx aa k ih y aa
ڈبہ	dx ah b b ax
ڈبہ	dx ih b b ax
ڈرنا	dx ah unk n aa
ڈسکہ	dx ah s k aa
ڈمبوداس	dx ah m b uw d aa s
ڈمرو	dx ah m unk uw
ڈنکرک	dx ah n k ah unk k
ڈنکی	dx ah ng k iy
ڈوری	dx ow unk iy
ڈونگا	dx ow ng g aa
ڈوور	dx ow v ah unk
ڈچ	dx ah ch
ڈڑھیل	dx ah r y ah l
ڈکار	dx ah k aa unk
ڈکار	dx ih k aa unk
ڈکی	dx ih k iy
ڈگمگانا	dx ah g m ah g aa n aa
ڈگی	dx ih unk iy
ڈھانپنا	dxh aa p n aa
ڈھانچہ	dxh aa n ch aa
ڈھاکہ	dxh aa k aa
ڈھول	dxh ow l
ڈھولک	dxh ow l ah k
ڈھونڈنا	dxh uw n dx n aa
ڈھونڈھ	dxh uw n dxh
ڈھيٹ	dxh iy tx
ڈھکن	dxh ah k k ah n
ڈہرکی	dx ah h ah unk k iy
ڈیرہ	dx ey unk aa
ڈیوڑھی	dx ey ow r iy
ڈیٹابیس	dx ey tx aa b ey s
ڈیٹھ	dx iy txh
ڑ	r
ڑ	r ey
ژ	zh
ژ	zh ey
ژالہ	zh aa l aa
ژوب	zh ow b
ژیان	zh ah y aa n
ژیاں	zh ih y aa
ک	k
ک	k aa f
کائنات	k aa ih n aa t
کابل	k aa b uh l
کابوس	k aa b uw s
کاتھولک	k aa th ow l ih k
کارا	k aa unk aa
کارخانہ	k aa unk unk aa n aa
کارروائی	k aa unk unk ah v aa iy
کارزار	k aa unk z aa unk
کارن	k aa unk ah n
کاروبار	k aa unk ow b aa unk
کارٹون	k aa unk tx uw n
کارکردگی	k aa unk k ah unk d ah g iy
کاشغر	k aa sh gq ah unk
کاغذ	k aa gq ah z
کاغذات	k aa gq ah z aa t
کالا	k aa l aa
کالج	k aa l ih jh
کالسروئے	k aa l s unk uw ey
کام	k aa m
کامل	k aa m ih l
کامونکے	k aa m ow ng k ey
کامیاب	k aa m y aa b
کان	k aa n
کانٹا	k aa tx aa
کانپنا	k aa p n aa
کاویہ	k aa v y ah
کاڑھا	k aa r aa
کاہکشان	k aa h k ah sh aa n
کب	k ah b
کبابیر	k ah b aa b iy unk
کباڑ	k ah b aa r
کبج	k uh b jh
کبریت	k ih b unk iy t
کبل	k ah b ah l
کبھو	k ah bh uw
کبھی	k ah bh iy
کبیر	k ah b iy unk
کتا	k uh t t aa
کتاب	k ih t aa b
کتراپی	k uh t unk aa p iy
کتره	k uh t r
کتھن	k ah th ah n
کتی	k ah t iy
کثرت	k ah s unk ah t
کدو	k ah d d uw
کدو	k ah d uw
کر	k ah unk
کراچوی	k ah unk aa ch ah v iy
کراچی	k ah unk aa ch iy
کردستان	k uh unk d ih s t aa n
کردن	k ah unk d ah n
کردنت	k unk ih d ah n t
کرسی	k uh unk s iy
کرشمہ	k ah unk ih sh m aa
کرغیزستان	k ih unk gq iy z ah s t aa n
کرم	k ah unk ah m
کرن	k ih unk ah n
کرنا	k ah unk n aa
کرناٹک	k ah unk n aa tx ah k
کرو	k ah unk ow
کرو	k uh unk uw
کروانا	k ah unk v aa n aa
کرکٹ	k ih unk k ih tx
کرکٹ	k unk ih k ih tx
کری	k ah unk iy
کریم	k ah unk iy m
کس	k uh s
کسان	k ih s aa n
کسی	k ih s iy
کشتی	k ih sh t iy
کشتی	k uh sh t iy
کشدھا	k sh uh dh aa
کشما	k sh ah m aa
کشمیر	k ah sh m iy unk
کشندہ	k uh sh ih n d aa
کشور	k ih sh ow unk
کشور	k ih sh v ah unk
کشور	k sh ao unk
کشٹ	k ah sh tx
کشیدگی	k ah sh iy d g iy
کعبہ	k aa b aa
کلاشنکوف	k l aa sh ih n k ow f
کلام	k ah l aa m
کلاونت	k ah l aa v ah n t
کلاں	k ah l aa
کلب	k l ah b
کلب	k ah l b
کلمہ	k ah l m aa
کلو	k ah l l uw
کلیان	k ah l y aa n
کلیجا	k ah l ey jh aa
کلیسیا	k ah l iy s ih y aa
کلیہ	k ah l y aa
کلیہ	k uh l l ih y y aa
کم	k ah m
کمائی	k ah m aa iy
کمال	k ah m aa l
کمالیہ	k ah m aa l ih y aa
کمان	k ah m aa n
کمانا	k ah m aa n aa
کمبل	k ah m b ah l
کمبوڈیا	k ah m b ow dx ih y aa
کمر	k ah m ah unk
کمرہ	k ah m unk aa
کمری	k ah m unk iy
کمل	k ah m ah l
کملا	k uh m ih l l aa
کملائی	k uh m ih l l aa iy
کمپ	k ah m p
کمپت	k ah m p ih t
کمپن	k ah m p ah n
کمپیوٹر	k ah m p y uw tx ah unk
کمھڑا	k uh m h ah r aa
کمھڑا	k uh m ah r aa
کمی	k ah m iy
کمیاب	k ah m y aa b
کمینہ	k ah m iy n aa
کمیٹی	k ah m ey tx iy
کنارہ	k ih n aa unk aa
کنجی	k uh n jh iy
کندرا	k ah n d ah unk aa
کندھا	k ah n dh aa
کنعان	k ah n unk aa n
کنفیوشس	k ah n f uh sh ah s
کنواری	k uh v aa unk iy
کنور	k uw ah unk
کنور	k uh w ah unk
کنور	k uh v ah unk
کنٹرول	k ah n tx unk ow l
کنڑ	k uh n ah r
کنکال	k ah ng k aa l
کنگارو	k ah ng g aa unk uw
کنگھی	k ah ng g iy
کنیز	k ah n iy z
کنیسہ	k ah n iy s aa
کو	k ow
کوئٹہ	k ow w ey tx aa
کوئی	k ow iy
کوا	k ah uw w aa
کوا	k ah v aa
کوتا	k ah v ih t aa
کورو	k ow unk ah v
کورو	k ao unk ah v
کوشش	k ow sh ih sh
کوفی	k ow f iy
کوفی	k ao f iy
کولر	k uw l ah unk
کولمبیا	k ow l ah m b ih y aa
کولن	k ow l ah n
کون	k ao n
کوٹری	k ow tx unk iy
کوٹھی	k ow txh iy
کوکب	k ao k ah b
کوہ	k ow h
کوہاٹ	k ow h aa tx
کوہرا	k uh h unk aa
کوہلو	k ow h l uw
کویت	k uh ey t
کویت	k uh v ey t
کویت	k uh v eh t
کٹھور	k ah txh ow unk
کٹی	k ah tx iy
کپاس	k ah p aa s
کپاسی	k ah p aa s iy
کپتان	k ah p t aa n
کپوت	k ah p ow t
کپڑا	k ah p r aa
کچا	k ah t ch aa
کچھ	k uh ch
کژدم	k ah zh d uh m
ککش	k ah k sh
کھاتا	kh aa t aa
کھاتوں	kh aa t ow
کھاتے	kh aa t ey
کھاد	kh aa d
کھان	kh aa n
کھانا	kh aa n aa
کھانگ	kh aa ng g
کھانگ	kh aa g
کھانی	kh aa n iy
کھاگ	kh aa g
کھجلی	kh ah jh uh l iy
کھجلی	kh uh jh l iy
کھجور	kh ah jh uw unk
کھدیوت	kh ah d y ow t
کھر	kh uh unk
کھرجو	kh ah unk jh uw
کھرنا	kh uh unk n aa
کھسرا	kh uh s unk aa
کھلنا	kh ih l n aa
کھلنا	kh uh l n aa
کھلونا	kh ih l ao n aa
کھنن	kh ah n ah n
کھنک	kh ah n ah k
کھنکنا	kh ah n ah k n aa
کھوٹا	kh ow tx aa
کھٹا	kh ah tx tx aa
کھٹائی	kh ah tx aa iy
کھڈا	kh ah dx dx aa
کھڑا	kh ah r aa
کھڑکی	kh ih r k iy
کھڑی	kh ah r iy
کھڑے	kh ah r ey
کھیت	kh ey t
کھیرا	kh iy unk aa
کھیل	kh ey l
کھیلا	kh ey l aa
کھیلنا	kh ey l n aa
کھینچنا	kh iy ch n aa
کھینچنا	kh eh ch n aa
کھینچنا	kh ih ch n aa
کہ	k ey
کہ	k ih
کہانی	k ah h aa n iy
کہاوت	k ah h aa v ah t
کہاں	k ah h aa
کہر	k ah h ah unk
کہرا	k uh h unk aa
کہنا	k ah h n aa
کہنی	k uh h n iy
کیا	k y aa
کیا	k ih y aa
کیتھولک	k eh th ow l ih k
کیرلا	k ey unk ah l aa
کیسے	k eh s ey
کیش	k ey sh
کیف	k iy f
کیل	k iy l
کیل	k eh l
کیلئے	k ey l ih y ey
کیلا	k ey l aa
کیلکولیٹر	k eh l k uw l ey tx ah unk
کیلی	k ey l iy
کیلے	k eh l ey
کیمرہ	k eh m unk aa
کیمیا	k iy m ih y aa
کیمیائی	k iy m ih y aa iy
کینسر	k eh n s ah unk
کینچلی	k eh ch uh l iy
کینڈی	k eh n dx iy
کینیا	k iy n ih y aa
کینیڈا	k eh n ey dx aa
کیوبیک	k w ih b eh k
کیول	k ey v ah l
کیچڑ	k iy ch ah r
کیڑا	k iy r aa
کیک	k ey k
کیکر	k iy k ah unk
کے	k ey
گ	g
گ	g aa f
گاؤں	g aa ow
گاؤں	g aa ow
گائے	g aa ey
گاتر	g aa t r
گاجر	g aa jh ah unk
گال	g aa l
گالی	g aa l iy
گام	g aa m
گان	g aa n
گانا	g aa n aa
گانجا	g aa n jh aa
گانو	g aa n ow
گانو	g aa ow
گانو	g aa v
گانوں	g aa n ow
گانوں	g aa ow
گانڈ	g aa n dx
گانڈو	g aa n dx uw
گانڈو	g aa dx uw
گانے	g aa n ey
گاو	g aa ow
گاو	g aa v
گاڑی	g aa r iy
گایک	g aa y ah k
گتا	g ah t t aa
گج	g ah jh
گجرات	g uh jh unk aa t
گدا	g uh d aa
گدگدانا	g uh d g uh d aa n aa
گدھ	g ih d dh
گدھا	g ah dh aa
گذارنا	g uh z aa unk n aa
گذراننا	g uh z unk aa n n aa
گذرنا	g uh z ah unk n aa
گرام	g unk aa m
گرانا	g ih unk aa n aa
گرج	g ah unk ah jh
گرجا	g ih unk jh aa
گرجنا	g ah unk ah jh n aa
گردن	g ah unk d ah n
گرز	g uh unk z
گرم	g ah unk m
گرم	g ah unk ah m
گرما	g ah unk m aa
گرمکھی	g uh unk m uh kh iy
گرمیاں	g ah unk m ih y aa
گرنا	g ih unk n aa
گرنتھ	g ah unk ah n th
گرو	g uh unk uw
گروہ	g ih unk ow h
گرڈ	g ah unk uh dx
گرہن	g unk ah h ah n
گزارش	g uh z aa unk ih sh
گزارہ	g uh z aa unk aa
گفتار	g uh f t aa unk
گفتگو	g uh f t g uw
گلاب	g uh l aa b
گلابی	g uh l aa b iy
گلاس	g l aa s
گلال	g uh l aa l
گلانی	g l aa n iy
گلشن	g uh l sh ah n
گلو	g ah l uw
گلو	g uh l ow
گلو	g uh l uw
گلگت	g ih l g ih t
گلہری	g ih l ah h unk iy
گلی	g ah l iy
گلیل	g ah l iy l
گلیم	g ih l iy m
گم	g uh m
گمان	g uh m aa n
گمانا	g uh m aa n aa
گمبھیر	g ah m bh iy unk
گمنام	g uh m n aa m
گناہ	g uh n aa h
گنبد	g uh m b ah d
گنبذ	g uh m b ah z
گنبھیر	g ax m bh iy unk
گنت	g ah n ih t
گنتی	g ih n t iy
گنجا	g ah n jh aa
گندمی	g ah n d uh m iy
گندگی	g ah n d ah g iy
گندھک	g ah n dh ah k
گندہ	g ah n d aa
گنی	g ih n iy
گنیش	g ah n ey sh
گوا	g ow aa
گوادر	g w aa d ah unk
گوادر	g uh aa d ah unk
گوبھی	g ow bh iy
گوجرانوالہ	g uh jh unk aa v aa l aa
گوجرہ	g ow jh unk aa h
گورا	g ow unk aa
گورداسپور	g ow unk d aa s p uw unk
گورستان	g ow unk ih s t aa n
گورمنٹ	g ow unk m ah n tx
گورو	g ao unk ah v
گوزن	g ow z ah n
گوزن	g ao z ah n
گوزن	g ah v z ah n
گوشت	g ow sh t
گول	g ow l
گولی	g ow l iy
گوٹھ	g ow txh
گوپن	g ow p ah n
گوگرد	g ow g ih unk d
گٹار	g ih tx aa unk
گٹھری	g ah txh unk iy
گپ	g ah p
گڈا	g uh dx dx aa
گڑ	g uh r
گڑھ	g ah r
گڑیا	g uh r ih y aa
گگن	g ah g ah n
گھاس	g aa s
گھاو	g aa v
گھاٹا	g aa tx aa
گھاٹا	g aa tx ah
گھبرانا	g ah b unk aa n aa
گھر	g ah unk
گھرانا	g ah unk aa n aa
گھرنا	g unk ih n aa
گھریلو	g ah unk ey l uw
گھمنڈ	g ah m ah n dx
گھنٹا	g ah n tx aa
گھنٹہ	g ah n tx aa
گھنٹی	g ah n tx iy
گھوش	g ow sh
گھونسلہ	g ow n s l aa
گھونٹ	g uw n tx
گھونٹ	g uw tx
گھوٹکی	g ow tx k iy
گھوڑا	g ow r aa
گھٹنا	g ah tx n aa
گھٹنا	g uh tx n aa
گھڑی	g ah r iy
گھڑیال	g ah r ih y aa l
گھی	g iy
گہرا	g ah h unk aa
گیا	g ah y aa
گیت	g iy t
گیر	g eh unk
گیزر	g iy z ah unk
گیس	g eh s
گیسن	g iy s ah n
گیلا	g iy l aa
گیند	g ey n d
گینڈا	g ey n dx aa
گینڈا	g eh n dx aa
گیہوں	g ey h uw
گے	g ey
ں	unk
ھ	unk
ھ	unk
ہ	aa
ہ	h
ہاتھ	h aa th
ہاتھی	h aa th iy
ہار	h aa unk
ہارون	h aa unk uw n
ہانک	h aa k
ہانکنا	h aa ng k n aa
ہاں	h aa
ہتھیار	h ah th ih y aa unk
ہتھیلی	h ah th ey l iy
ہتیارا	h ah t y aa unk aa
ہجوم	h uh jh uw m
ہجے	h ih d jh ey
ہدایت	h ih d aa y ah t
ہرانا	h ah unk aa n aa
ہرن	h ih unk ah n
ہرنائی	h ah unk n aa iy
ہریانہ	h ah unk ih y aa n aa
ہسپانی	h ah s p aa n iy
ہسپانیہ	h ah s p aa n ih y aa
ہفتو	h ah f t ow
ہفتوں	h ah f t ow
ہفتہ	h ah f t aa
ہفتے	h ah f t ey
ہفوۃ	h ah f v ah t
ہل	h ah l
ہلسہ	h ih l s aa
ہلو	hh ah l uw
ہلکا	h ah l k aa
ہلکان	h ah l k aa n
ہم	h ah m
ہمارا	h ah m aa unk aa
ہمالیہ	h ih m aa l ih y ah
ہماہمی	h ah m aa h ah m iy
ہمایوں	h uh m aa y uw
ہمت	h ih m m ah t
ہمجنسیت	h ah m jh ih n s ih y ah t
ہمسفر	h ah m s ah f ah unk
ہمیشگی	h ah m ey sh g iy
ہمیشہ	h ah m ey sh aa
ہمیں	h ah m eh
ہند	h ih n d
ہندو	h ih n d uw
ہندوتوا	h ih n d uw t w aa
ہندوتوا	h ih n d uh t v aa
ہندوستان	h ih n d ow s t aa n
ہندوستان	h ih n d uh s t aa n
ہندوستانی	h ih n d uw s t aa n iy
ہندوستانی	h ih n d uh s t aa n iy
ہندوی	h ih n d v iy
ہندی	h ih n d iy
ہندیہ	h ih n d ih y aa
ہنزلو	h ah n z l ow
ہنسا	h ih n s aa
ہنساتمک	h ih n s aa t m ah k
ہنسلو	h ah n s l ow
ہنسنا	h aa n s n aa
ہنسنا	h ah s n aa
ہنسنا	h ax s n aa
ہنڈی	h uh n dx iy
ہنگامی	h ah ng g aa m iy
ہوا	h uw aa
ہوا	h ah v aa
ہوائی	h ah v aa iy
ہوتا	h ow t aa
ہود	h uw d
ہوس	h ah v ah s
ہوسیع	h uw s iy unk aa
ہوشنگ	h ow sh ah ng g
ہوشیار	h ow sh ih y aa unk
ہوشیع	h uw sh iy unk aa
ہولی	h ow l iy
ہونا	h ow n aa
ہونٹ	h ow n tx
ہونٹ	h ow tx
ہونٹھ	h ow n txh
ہوٹل	h ow tx ah l
ہوں	h uw
ہچکنا	h ih ch ah k n aa
ہچکی	h ih ch k iy
ہڈی	h ah dx iy
ہکا	h ih k k aa
ہیجڑا	h iy jh r aa
ہیر	h iy unk
ہیرا	h iy unk aa
ہیضہ	h eh z aa
ہیمبرگ	h eh m b ah unk g
ہیمبرگ	h eh m b uh unk g
ہیک	h iy k
ہیں	h eh
ہے	ey
ہے	eh
ہے	h ey
ہے	h eh
ی	ey
ی	iy
ی	y
ی	eh
یا	y aa
یات	ih y aa t
یاد	y aa d
یار	y aa unk
یاسمین	y aa s ah m iy n
یال	y aa l
یاور	y aa v ah unk
یت	y uh t
یت	ih y ah t
یتیم	y ah t iy m
یحیی	y ah h y aa
یخ	y ah unk
یدھ	y uh d dh
یدھ	y uh dh
یرغمال	y ah unk gq ah m aa l
یرمیاہ	y ih unk m ih y aa h
یروشلم	y ah unk ow sh ah l ah m
یروشلم	y ah unk uw sh l ah m
یروشلم	y ah unk uh sh ah l ah m
یزدان	y ah z d aa n
یزیدیت	y ah z iy d ih y ah t
یسعیاہ	y ah s aa unk y aa h
یسوع	y ah s uw unk
یعقوب	y ah unk q uw b
یعنی	y aa n iy
یقین	y ah q iy n
یقینا	y ah q iy n ah n
یمن	y ah m ah n
یمنا	y ah m uh n aa
ین	iy n
یوحنا	y uw h ah n n aa
یورش	y uw unk ih sh
یوروپ	y uw unk ow p
یورپ	y uw unk ah p
یوسف	y uw s uh f
یوغ	y ow gq
یوغ	y uw gq
یوم	y ao m
یون	y ah v ah n
یونان	y uw n aa n
یونانی	y uw n aa n iy
یونس	y uw n uh s
یوکرین	y uw k unk ey n
یوگدان	y ow g d aa n
یوگنڈا	y uw g ah n dx aa
یوگیتو	y ow g y ah t v
یوگیہ	y ow g y h
یوں	y ow
یوں	y uw
یک	y ah k
یکتا	y ah k t aa
یکم	y ah k uh m
یکیدم	y ah k iy d ah m
یگانہ	y ah g aa n aa
یہ	y ey
یہاں	y ah h aa
یہود	y ah h uw d
یہودنی	y ah h uw d n iy
یہودنی	y ah h uw d ih n iy
یہودی	y ah h uw d iy
یہودیت	y ah h uw d iy t
یہودیت	y ah h uw d ih y ah t
یہودیہ	y ah h uw d ih y aa
ے	ey
ے	eh
